Algerian	Algiers
Angolan	Luanda
Beninese	Porto-Novo
Burundian	Bujumbura
Cameroonian	Yaoundé
Chadian	N'Djamena
Congolese	Brazzaville
Egyptian	Cairo
Eritrean	Asmara
Liberian	Monrovia
Libyan	Tripoli
Malawian	Lilongwe
Mauritanian	Nouakchott
Mauritian	Port Louis
Moroccan	Rabat
Namibian	Windhoek
Nigerian	Abuja
Rwandan	Kigali
Senegalese	Dakar
Sudanese	Khartoum
Tanzanian	Dodoma
Togolese	Lomé
tunisian	Tunis
Ugandan	Kampala
Zambian	Lusaka
Zimbabwean	Harare
Afghan	Kabul
Chinese	Beijing
Georgian	Tbilisi
Indian	New Delhi
Indonesian	Jakarta
Iranian	Tehran
Iraqi	Baghdad
Israeli	Jerusalem
Japanese	Tokyo
Jordanian	Amman
Kuwaiti	Kuwait City
Laotian	Vientiane
Lebanese	Beirut
Mongolian	Ulaanbaatar
Nepalese	Kathmandu
Korean	Pyongyang
Omani	Muscat
Pakistani	Islamabad
Palestinian	East Jerusalem
Philippine	Manila
Qatari	Doha
Singaporean	Singapore
Syrian	Damascus
Taiwanese	Taipei
Thai	Bangkok
Turkish	Ankara
Vietnamese	Hanoi
Yemeni	Sana'a
Albanian	Tirana
Andorran	Andorra la Vella
Australian	Vienna
Belarusian	Minsk
Belgian	Brussels
Bulgarian	Sofia
Croatian	Zagreb
Estonian	Tallinn
Franch	Paris
Germany	Berlin
Hungarian	Budapest
Icelandic	Reykjavík
Italian	Rome
Latvian	Riga
Macedonian	Skopje
Maltese	Valletta
Moldovan	Chişinău
Monacan	Monaco
Montenegrin	Podgorica
Norwegian	Oslo
Portuguese	Lisbon
Romanian	Bucharest
Russian	Moscow
Serbian	Belgrade
Slovakian	Bratislava
Slovenian	Ljubljana
Spanish	Madrid
Swedish	Stockholm
Ukrainian	Kiev
Bahamian	Nassau
Belizean	Belmopan
Bermudian	Hamilton
Canadian	Ottawa
Cuban	Havana
Dominican	Roseau
Greenlandic	Nuuk
Grenadian	St. George's
Guatemalan	Guatemala City
Haitian	Port-au-Prince
Honduran	Tegucigalpa
Jamaican	Kingston
Mexican	Mexico City
Nicaraguan	Managua
Panamanian	Panama City
Argentinian	Buenos Aires
Bolivian	Sucre
Brazilian	Brasília
Chilean	Santiago
Colombian	Bogotá
Ecuadorian	Quito
Guyanese	Georgetown
Paraguayan	Asunción
Peruvian	Lima
Uruguayan	Montevideo
Venezuelan	Caracas
Australian	Canberra
Fijian	Suva
Guamanian	Hagåtña
Micronesian	Palikir
Nauruan	Yaren
Palauan	Ngerulmud
Samoan	Apia
Tongan	Nukuʻalofa
Tuvaluan	Funafuti
Algeria	Algiers
Angola	Luanda
Benin	Porto-Novo
Burundi	Bujumbura
Cameroon	Yaoundé
Chad	N'Djamena
Congo	Brazzaville
Egypt	Cairo
Eritrea	Asmara
Liberia	Monrovia
Libya	Tripoli
Malawi	Lilongwe
Mauritania	Nouakchott
Mauritius	Port Louis
Morocco	Rabat
Namibia	Windhoek
Nigeria	Abuja
Rwanda	Kigali
Senegal	Dakar
Sudan	Khartoum
Tanzania	Dodoma
Togo	Lomé
Tunisia	Tunis
Uganda	Kampala
Zambia	Lusaka
Zimbabwe	Harare
Afghanistan	Kabul
China	Beijing
Georgia	Tbilisi
India	New Delhi
Indonesia	Jakarta
Iran	Tehran
Iraq	Baghdad
Israel	Jerusalem
Japan	Tokyo
Jordan	Amman
Kuwait	Kuwait City
Laos	Vientiane
Lebanon	Beirut
Mongolia	Ulaanbaatar
Nepal	Kathmandu
North Korea	Pyongyang
Oman	Muscat
Pakistan	Islamabad
Palestine	East Jerusalem
Philippines	Manila
Qatar	Doha
Singapore	Singapore
Syria	Damascus
Taiwan	Taipei
Thailand	Bangkok
Turkey	Ankara
Vietnam	Hanoi
Yemen	Sana'a
Albania	Tirana
Andorra	Andorra la Vella
Austria	Vienna
Belarus	Minsk
Belgium	Brussels
Bulgaria	Sofia
Croatia	Zagreb
Estonia	Tallinn
France	Paris
Germany	Berlin
Hungary	Budapest
Iceland	Reykjavík
Italy	Rome
Latvia	Riga
Macedonia	Skopje
Malta	Valletta
Moldova	Chişinău
Monaco	Monaco
Montenegro	Podgorica
Norway	Oslo
Portugal	Lisbon
Romania	Bucharest
Russia	Moscow
Serbia	Belgrade
Slovakia	Bratislava
Slovenia	Ljubljana
Spain	Madrid
Sweden	Stockholm
Ukraine	Kiev
Bahamas	Nassau
Belize	Belmopan
Bermuda	Hamilton
Canada	Ottawa
Cuba	Havana
Dominica	Roseau
Greenland	Nuuk
Grenada	St. George's
Guatemala	Guatemala City
Haiti	Port-au-Prince
Honduras	Tegucigalpa
Jamaica	Kingston
Mexico	Mexico City
Nicaragua	Managua
Panama	Panama City
Argentina	Buenos Aires
Bolivia	Sucre
Brazil	Brasília
Chile	Santiago
Colombia	Bogotá
Ecuador	Quito
Guyana	Georgetown
Paraguay	Asunción
Peru	Lima
Uruguay	Montevideo
Venezuela	Caracas
Australia	Canberra
Fiji	Suva
Guam	Hagåtña
Micronesia	Palikir
Nauru	Yaren
Palau	Ngerulmud
Samoa	Apia
Tonga	Nukuʻalofa
Tuvalu	Funafuti