Alianza Bolivariana para los Pueblos de Nuestra América - Tratado de Comercio de los Pueblos	m.08_fyc	ORG
Grupo Confederal de la Izquierda Unitaria Europea / Izquierda Verde Nórdica	m.02pfd	ORG
Ministerio de Relaciones Exteriores y de la Mancomunidad de Naciones	m.0g7hr	ORG
Consejo de Cooperación para los Estados Árabes del Golfo Pérsico	m.01g87g	ORG
Ministerio de Relaciones Exteriores de la República Popular China	m.02626pc	ORG
Agencia de los Estados Unidos para el Desarrollo Internacional	m.011hwh	ORG
Servicio de Ciudadanía e Inmigración de los Estados Unidos	m.021psw	ORG
society for worldwide interbank financial telecommunication	m.0cx1t	ORG
department of homeland security office of inspector general	m.02r52hq	ORG
Tribunal Penal Militar Internacional para el Lejano Oriente	m.02032g	ORG
Society for Worldwide Interbank Financial Telecommunication	m.0cx1t	ORG
Frente Unido Nacional por la Democracia contra la Dictadura	m.04jf9j1	ORG
Alto Comisionado de las Naciones Unidas para los Refugiados	m.07vqq	ORG	NAM
Primer Circuito de Cortes de Apelaciones de Estados Unidos	m.027b3s	ORG
Departamento de Seguridad Nacional de los Estados Unidos	m.0fytk	ORG
Comisión Militar Central de la República Popular China	m.01fdgm	ORG
Sección de Intereses de los Estados Unidos en La Habana	m.0cbw0j	ORG
massachusetts institute of technology police department	m.0t52dbz	ORG
Instituto de Investigación de Medios del Medio Oriente	m.01zbff	ORG
Agencia de Alcohol, Tabaco, Armas de Fuego y Explosivos	m.01ymr_	ORG
Fuerzas Terrestres del Ejército Popular de Liberación	m.04qcbw	ORG
executive office of the president of the united states	m.0c0cs	ORG
Fuerzas Especiales del Ejército de los Estados Unidos	m.01vf1h	ORG
Oficina Ejecutiva del Presidente de los Estados Unidos	m.0c0cs	ORG
Asociación Internacional de Federaciones de Atletismo	m.0lvzl	ORG
Oficina de Naciones Unidas contra la Droga y el Delito	m.0539yq	ORG
Mando de Operaciones Especiales de los Estados Unidos	m.027qkk	ORG
republican party of russia – people's freedom party	m.0642d9w	ORG
Organización Internacional para la Energía Atómica	m.03w28	ORG
Department of Homeland Security inspector’s general	m.02r52hq	ORG
United States Court of Appeals for the First Circuit	m.027b3s	ORG
US District Court for the District of Massachusetts	m.03pkgh	ORG
Consejo de Seguridad Nacional de los Estados Unidos	m.0c0bf	ORG
Comité de Relaciones Públicas Americano-Isralíes	m.018_n5	ORG
Departamento Estatal de Servicios de Salud de Texas	m.05p1d8j	ORG
Consejo de Derechos Humanos de las Naciones Unidas	m.02z4f6	ORG
united states agency for international development	m.011hwh	ORG
Fuerza Aérea del Ejército Popular de Liberación	m.021n5b	ORG
Organización de Países Exportadores de Petróleo	m.0165_d	ORG
international association of athletics federations	m.0lvzl	ORG
Estado para los Asuntos del Hemisferio Occidental	m.0bhct4	ORG
Conferencia Consultiva Política del Pueblo Chino	m.01g99q	ORG
Aeropuerto Internacional de Moscú-Sheremétievo	m.01n53t	FAC
Consejo de Paz y Seguridad de la Unión Africana	m.0cny569	ORG
United States House Committee on Foreign Affairs	m.04nngd	ORG
international military tribunal for the far east	m.02032g	ORG
International Military Tribunal For The Far East	m.02032g	ORG
Unión Estadounidense por las Libertades Civiles	m.0vkm	ORG
Cámara de Representantes de los Estados Unidos	m.0b3wk	ORG
Sede de la Organización de las Naciones Unidas	m.019vsd	FAC	NAM
Cuerpos de la Guardia Revolucionaria Islámica	m.04q3gn	ORG
Organización para la Liberación de Palestina	m.062dz	ORG
Center for Strategic and International Studies	m.02n4mz	ORG
Comité Central del Partido Comunista de China	m.01y9g2	ORG
Sección de Intereses de la República de Cuba	m.080l9g4	ORG
Departamento de Justicia de los Estados Unidos	m.0dtj5	ORG
center for strategic and international studies	m.02n4mz	ORG
Foro de Cooperación Económica Asia-Pacífico	m.01027r	ORG
Ministerio de Relaciones Exteriores de Israel	m.04cv0d6	ORG
Asociación de Naciones del Sureste Asiático	m.0qnfv	ORG
united states department of homeland security	m.0fytk	ORG
Departamento del Tesoro de los Estados Unidos	m.0f1r9	ORG
Departamento de Defensa de los Estados Unidos	m.07y0n	ORG
Administración de Seguridad en el Transporte	m.0179dd	ORG
Departamento de Estado de los Estados Unidos	m.07vsl	ORG
Organismo Internacional de Energía Atómica	m.03w28	ORG
john joseph moakley united states courthouse	m.06hgjl	FAC
Centre National de la Recherche Scientifique	m.012bcd	ORG
Tribunales de Distrito de los Estados Unidos	m.0j75z	ORG
Estado Adjunta para el Hemisferio Occidental	m.0bhct4	ORG
Observatorio Sirio para los Derechos Humanos	m.0hr9tzh	ORG
Comisión Electoral Independiente de Nigeria	m.02q2wn5	ORG
Oficina de Asuntos del Hemisferio Occidental	m.0bhct4	ORG
Proyecto para el Nuevo Siglo Estadounidense	m.01c4wz	ORG
Departamento federal de justicia y policía	m.02hnhx	ORG
Corte Suprema de Apelación de Bloemfontein	m.04_hbs	ORG
Ministerio de Asuntos Exteriores de Francia	m.01l2_d	ORG
Fuerzas Armadas Revolucionarias de Colombia	m.06hvg	ORG
Asamblea Nacional del Poder Popular de Cuba	m.087rgx	ORG
arab socialist ba'ath party – iraq region	m.0hncp2r	ORG
Secretaría de Hacienda y Crédito Público	m.026p_2j	ORG
Federación de Fútbol de las Islas Caimán	m.0flzx4	ORG
Sección de Intereses de Cuba en Washington	m.080l9g4	ORG
farc revolutionary armed forces of colombia	m.06hvg	ORG
Tribunal del Distrito del condado de Erath	m.06_93ph	FAC
Servicio de Inmigración y Naturalización	m.01524h	ORG	NAM
Washington Institute for Near East Affairs	m.070_y5	ORG
Al-Dawla Al-Islamiya fi al-Iraq wa al-Sham	m.027x630	ORG
Islamic State of Iraq and the Levant group	m.027x630	ORG
north atlantic treaty organization (nato)	m.059dn	ORG
u.s. citizenship and immigration services	m.021psw	ORG
Washington Institute for Near East Policy	m.070_y5	ORG
Ministerio de Asuntos Exteriores de Rusia	m.0c2105	ORG	NAM
Partido Nacionalsocialista Obrero Alemán	m.05g9h	ORG
Independent National Electoral Commission	m.02q2wn5	ORG
Servicio Geológico de los Estados Unidos	m.01b69s	ORG
Partido Comunista de la Unión Soviética	m.02245	ORG
Partido Republicano de los Estados Unidos	m.07wbk	ORG
Línea de Alta Velocidad Pekín-Shanghái	m.08fskg	ORG
Universidad de Massachusetts en Dartmouth	m.023zrb	ORG
independent national electoral commission	m.02q2wn5	ORG
Defense Advanced Research Projects Agency	m.02gv2	ORG
American Israel Public Affairs Committee	m.018_n5	ORG
american israel public affairs committee	m.018_n5	ORG
Departamento de Estado de Estados Unidos	m.07vsl	ORG
Observatorio Naval de los Estados Unidos	m.0by04	FAC
african national congress women's league	m.03ch85f	ORG
Misión de la Unión Africana en Somalia	m.0g_sw6	ORG
Departamento de Servicios Correccionales	m.0d1hqh	ORG
united states department of the treasury	m.0f1r9	ORG
Athens Water Supply and Sewerage Company	m.012w3pq1	ORG
Partido Demócrata de los Estados Unidos	m.0d075m	ORG
ministry of foreign and european affairs	m.01l2_d	ORG
Muhammadu Chukwuma Pious Adekunle Buhari	m.02p45h	PER
Asamblea General de las Naciones Unidas	m.07vp7	ORG
united states national security council	m.0c0bf	ORG
Instituto Tecnológico de Massachusetts	m.04rwx	ORG
José Mário dos Santos Mourinho Félix	m.0378hn	PER	NAM
Federación Internacional de Baloncesto	m.045v50	ORG
Administration of the Russian President	m.027nxt9	ORG
federal government of the united states	m.01bqks	ORG
Cuerpo de Marines de los Estados Unidos	m.01skqzw	ORG
the poynter institute for media studies	m.03mj0sh	ORG
Organización de los Estados Americanos	m.05pzq	ORG
Consejo de Seguridad de Naciones Unidas	m.07vnr	ORG
National Center for Scientific Research	m.012bcd	ORG
women's national basketball association	m.0fv18	ORG
national federation of republican women	m.03ydn50	ORG
Observatorio Sirio de Derechos Humanos	m.0hr9tzh	ORG
Revolutionary Armed Forces of Colombia	m.06hvg	ORG
Base Naval de la Bahía de Guantánamo	m.03dvr	FAC
south african broadcasting corporation	m.01_sgp	ORG
united states house of representatives	m.0b3wk	ORG
Transportation Security Administration	m.0179dd	ORG
Región económica de Siberia del Este	m.025t91x	LOC
Secretaría General de Naciones Unidas	m.015kq0	ORG
Guardia Nacional de los Estados Unidos	m.09gs3	ORG
Aeropuerto Internacional Jomo Kenyatta	m.011zcr	FAC
South African Broadcasting Corporation	m.01_sgp	ORG
united states national security agency	m.05htt	ORG
Comité Internacional de la Cruz Roja	m.0c_bfw	ORG
Massachusetts Institute of Technology	m.04rwx	ORG
saud bin faisal bin abdulaziz al saud	m.02zqhd	PER
university of massachusetts dartmouth	m.023zrb	ORG
European United Left/Nordic Green Lef	m.02pfd	ORG
massachusetts institute of technology	m.04rwx	ORG
Estado Islámico de Irak y el Levante	m.027x630	ORG
Aeropuerto Internacional de Katmandú	m.07kd55	ORG
U.S. Customs and Immigration Services	m.021psw	ORG
Área libre de la República de China	m.097hdf	LOC	NAM
Fuerzas armadas de los Estados Unidos	m.07xg1	ORG
Foundation for Defense of Democracies	m.02ff9q	ORG
Agencia Telegráfica Central de Corea	m.02ys4j	ORG	NAM
Aeropuerto Internacional de Maiduguri	m.0281fkx	FAC
Europa de la Libertad y la Democracia	m.06w22tt	ORG
Organización de las Naciones Unidas	m.07t65	ORG
Asociación de Fútbol de Inglaterra	m.0chl9	ORG
Agencia Rusa de Información Novosti	m.0d6h97	ORG
Islamic State of Iraq and the Levant	m.027x630	ORG
Federación Costarricense de Fútbol	m.06jgt2	ORG
Confederación Brasileña de Fútbol	m.032jvc	ORG
project for the new american century	m.01c4wz	ORG
Mando Central de los Estados Unidos	m.01xsrd	ORG
united nations human rights council	m.02z4f6	ORG
Gobierno de la Federación de Rusia	m.02ps5qq	GPE
Distrito federal del Cáucaso Norte	m.09v9khv	GPE
Corte Suprema de los Estados Unidos	m.07sz1	ORG
Colegio electoral de Estados Unidos	m.0lq3t	ORG
united states department of defense	m.07y0n	ORG
República Bolivariana de Venezuela	m.07ylj	GPE
israeli ministry of foreign affairs	m.04cv0d6	ORG
Selección de fútbol de Sudáfrica	m.03zrc_	ORG
Centro de detención de Guantánamo	m.0c0llt	FAC
United States Department of Justice	m.0dtj5	ORG
Ministerio de Relaciones Exteriores	m.04f63rh	ORG
The Chinese University of Hong Kong	m.01npqh	ORG
united states department of justice	m.0dtj5	ORG
Organización de Estados Americanos	m.05pzq	ORG
Coalition of the Radical Left Party	m.0b12mv	ORG
Organización Mundial del Comercio	m.085h1	ORG
Asamblea Popular Nacional de China	m.0c3xm	ORG
national intelligence organization	m.025tlwl	ORG
Congreso de Todos los Progresistas	m.0r4k3hv	ORG
whitewater development corporation	m.04njqx	ORG
international atomic energy agency	m.03w28	ORG
Rotonda del Observatorio número 1	m.023wv_	FAC
north atlantic treaty organization	m.059dn	ORG
supreme court of the united states	m.07sz1	ORG
National Intelligence Organization	m.025tlwl	ORG
Comisión Electoral Independiente	m.02q2wn5	ORG
Alianza Popular por la Democracia	m.0djyqj	ORG
Paris Saint-Germain Football Club	m.01_1kk	ORG	NAM
national iranian american council	m.0c5xyj	ORG
Natural Resources Defense Council	m.0fzvn	ORG
central intelligence agency (cia)	m.0d6qjf	ORG
República Democrática del Congo	m.088xp	GPE
Federación Venezolana de Fútbol	m.064gzt	ORG
investigative committee of russia	m.0g9x775	ORG
Organización Mundial de la Salud	m.0840w	ORG
Asuntos del Hemisferio Occidental	m.0bhct4	ORG
united states department of state	m.07vsl	ORG
winchester repeating arms company	m.058pnp	ORG
The Coalition of the Radical Left	m.0b12mv	ORG
palestine liberation organization	m.062dz	ORG
al-Qaeda in the Arabian Peninsula	m.02psd87	ORG
República Federal de Yugoslavia	m.018j0w	GPE
Ministerio del Interior de Rusia	m.0dy22	ORG
british broadcasting corporation	m.0ncl8zk	ORG
Hotel Intercontinental Park Lane	m.09k5rww	FAC
Unión de Naciones Suramericanas	m.04mj68	ORG
Fondo Mundial para la Naturaleza	m.0829b	ORG
Foundation for Middle East Peace	m.02vl7_r	ORG
Serguéi Kuzhuguétovich Shoigú	m.03hv9c	PER	NAM
Presidente de los Estados Unidos	m.060d2	ORG
Ejército Popular de Liberación	m.0hmvg	ORG
african union mission to somalia	m.0g_sw6	ORG
Fuerzas de Autodefensa de Japón	m.082lj7	ORG	NAM
Parque de los Héroes Nacionales	m.0cgzzc	FAC
sajida mubarak atrous al-rishawi	m.08vlt_	PER
African Union Mission in Somalia	m.0g_sw6	ORG
parliament of the united kingdom	m.03mkh	ORG
North Caucasian Federal District	m.09v9khv	GPE
democratic republic of the congo	m.088xp	GPE
British Broadcasting Corporation	m.0ncl8zk	ORG
Unión de Tribunales Islámicos	m.0dlrbn	ORG
Senate Armed Services Committee	m.02kfv7	ORG
Department of Homeland Security	m.0fytk	ORG
Comité Olímpico Internacional	m.03xcc	ORG
Agencia Central de Inteligencia	m.0d6qjf	ORG
islamic state of iraq and syria	m.027x630	ORG
República Democrática Alemana	m.03f2w	GPE
federal bureau of investigation	m.02_1m	ORG
arab states of the persian gulf	m.08qmn6	LOC
Capitolio de los Estados Unidos	m.07vth	FAC
United States Geological Survey	m.01b69s	ORG
Maiduguri International Airport	m.0281fkx	FAC
Tribhuvan International Airport	m.07kd55	FAC
islamic state in iraq and syria	m.027x630	ORG
Unidades de Protección Popular	m.0kbh1z3	ORG
dmitry konstantinovich kiselyov	m.0zn17kc	PER
International Olympic Committee	m.03xcc	ORG
Ejército de los Estados Unidos	m.07wh1	ORG
Cristina Fernández de Kirchner	m.05k5_1	PER
foreign and commonwealth office	m.0g7hr	ORG
José Antonio Gonzalez Carbajal	m.0275mlq	PER
national basketball association	m.05jvx	ORG
Residencia Oficial de Los Pinos	m.05784f	FAC
gulf coast of the united states	m.034rx	LOC
Islamic State of Iraq and Syria	m.07v2k4	ORG
Fuerza Marítima de Autodefensa	m.0774gm	ORG	NAM
Congress for Progressive Change	m.0glsddp	ORG
Víktor Fédorovich Yanukóvich	m.023115	PER	NAM
Partido Democrático del Pueblo	m.0276bn	ORG
united nations security council	m.07vnr	ORG
Corte Internacional de Justicia	m.03vls	ORG
al-Qaeda in the Islamic Maghreb	m.02qr9gb	ORG
Tribunal de Arbitraje Deportivo	m.03r121	ORG
all progressives grand alliance	m.05_2sq	ORG
Kathmandu International Airport	m.07kd55	FAC
United States Naval Observatory	m.0by04	FAC
Harakat al-Shabab al-Mujahideen	m.027ggxz	ORG
al Qaeda in the Islamic Maghreb	m.02qr9gb	ORG
International Court of Justice	m.03vls	ORG
national prosecuting authority	m.06mj8k	ORG
Gabinete de los Estados Unidos	m.07x_h	ORG
international court of justice	m.03vls	ORG
president of the united states	m.060d2	ORG
Court of Arbitration for Sport	m.03r121	ORG
Congreso de los Estados Unidos	m.07t31	ORG
Asamblea Nacional de Venezuela	m.02j_vd	ORG
Universidad de Texas en Austin	m.07w0v	ORG
Gobierno de los Estados Unidos	m.01bqks	ORG
Avenida de los Campos Elíseos	m.0jd4j	FAC
Mesa de la Unidad Democrática	m.0czf0s1	ORG
Conflicto de las islas Kuriles	m.01px32	LOC
Consejo de Seguridad de la ONU	m.07vnr	ORG
court of arbitration for sport	m.03r121	ORG
National Prosecuting Authority	m.06mj8k	ORG
Universidad China de Hong Kong	m.01npqh	ORG
palestinian national authority	m.0604m	ORG
Servicio Federal de Seguridad	m.0225tg	ORG
Manchester City Football Club	m.01634x	ORG	NAM
Bolshoy Zamoskvoretsky Bridge	m.0285n2c	FAC
Bernie "Mothafuckin'" Sanders	m.01_gbv	PER
harakat al-shabaab mujahideen	m.027ggxz	ORG
Oficina de Asuntos de Taiwán	m.05gbcw	ORG
Number One Observatory Circle	m.023wv_	FAC
united kingdom special forces	m.078r1r	ORG
Investigatory Powers Tribunal	m.0g9_1tg	ORG
Agencia de Seguridad Nacional	m.05htt	ORG
American Broadcasting Company	m.0gsg7	ORG
Universidad George Washington	m.01nnsv	ORG
Basque Fatherland and Liberty	m.02pvw	ORG
American Enterprise Institute	m.0p8q4	ORG
Al Qaeda del Magreb Islámico	m.02qr9gb	ORG
Banco de desarrollo del BRICS	m.0s8wz2z	ORG
nigerian presidential complex	m.07h407	FAC
Republican National Committee	m.01w5q_	ORG
Union of Concerned Scientists	m.02hc46	ORG
Tumba del Soldado Desconocido	m.01ckd2	FAC
Consejo de Seguridad Nacional	m.0c0bf	ORG
Sikorsky Aircraft Corporation	m.01ncxn	ORG
Federal Government of Nigeria	m.05cgv	GPE
Fondo Monetario Internacional	m.03y48	ORG
Orlando Pirates Football Club	m.01xbpn	ORG
guantanamo bay detention camp	m.0c0llt	FAC
american broadcasting company	m.0gsg7	ORG
Provincia Occidental del Cabo	m.01tjt2	ORG
Tribunal Superior de Pretoria	m.03gw1gv	ORG
east siberian economic region	m.025t91x	LOC
Banco Asiático de Desarrollo	m.0_2v	ORG
League of Conservation Voters	m.02dqck	ORG
José Antonio Meade Kuribre?a	m.0wykx8x	PER
National Prosecuting Authorit	m.06mj8k	ORG
united states central command	m.01xsrd	ORG
National Broadcasting Company	m.05gnf	ORG
Fuerzas de Defensa de Israel	m.09s93	ORG
Comité Nacional Republicano	m.01w5q_	ORG
Partido Democrático Popular	m.0276bn	ORG
Autoridad Nacional Palestina	m.0604m	ORG
council on foreign relations	m.01d_8r	ORG
international criminal court	m.03v8k	ORG
Fracción del Ejército Rojo	m.06gt7	ORG
Partido Unionista del Ulster	m.0j8cs	ORG
Estado de los Estados Unidos	m.0d0xs	GPE
the new york review of books	m.01rdhr	ORG
Partido Comunista de Ucrania	m.026xk6	ORG
south african police service	m.04k77f	ORG
Aeropuerto Internacional Moi	m.0gmjc3	FAC
Hyundai Kia Automotive Group	m.02bcwv	ORG
International Criminal Court	m.03v8k	ORG
South African Police Service	m.04k77f	ORG
Partido Popular Democrático	m.024tv3	ORG
República Popular de Benín	m.0fsfyj	GPE
South Africa's Supreme Court	m.04_hbs	ORG
All Nigeria People’s Party	m.024tv3	ORG
Islamic State of West Africa	m.06zrg5s	ORG
Prime Minister’s Residence	m.0cc6jnf	FAC
The New York Review of Books	m.01rdhr	ORG
Tribunal Penal Internacional	m.03v8k	ORG
Abdullah bin Zayed Al Nahyan	m.0bfxlk	PER
Armada de los Estados Unidos	m.07wg3	ORG
Partido del Trabajo de Corea	m.023t4w	ORG	NAM
Council on Foreign Relations	m.01d_8r	ORG
Televisión Central de China	m.0kcyk	ORG
Senado de los Estados Unidos	m.07t58	ORG
Tokyo Electric Power Company	m.03l8r4	ORG	NAM
cabinet of the united states	m.07x_h	ORG
Abdihakim Haji Mohamud Fiqi	m.0gh8w_m	PER
Radio France Internationale	m.0b40z7	ORG
ministry of foreign affairs	m.05b4kqr	ORG
Federal Republic of Nigeria	m.05cgv	GPE
high courts of south africa	m.04_hdx	ORG
International Monetary Fund	m.03y48	ORG
María Yúrievna Sharápova	m.03b7gw	PER	NAM
New Tang Dynasty Television	m.05g977	ORG
Kaizer Chiefs Football Club	m.01xbp7	ORG
Institute of Asian Research	m.0cq3g7	ORG
Facultad de Derecho de Yale	m.02bq1j	ORG
Real Madrid Club de Fútbol	m.06l22	ORG
central intelligence agency	m.0d6qjf	ORG
Judaísmo Unido de la Torá	m.01pnbc	ORG
Federal Election Commission	m.01jlfh	ORG
Corte Suprema de Apelación	m.04_hbs	ORG
Fuerzas Armadas Británicas	m.07sx7	ORG
Boston Athletic Association	m.0ckd9b	ORG
Baltimore Police Department	m.098sfc	ORG
US District Court in Boston	m.03pkgh	ORG
Vicente Rodríguez Guillén	m.06kr_p	PER
Partido de los Trabajadores	m.01gqn1	ORG
Cementerio Estatal de Texas	m.092yjl	FAC
Partido Comunista de China	m.02189	ORG
Partido Comunista Francés	m.01v8x4	ORG
Brennan Center for Justice	m.02pjfvw	ORG
London School of Economics	m.0hsb3	ORG
jacqueline kennedy onassis	m.0h6mq	PER
Walnut Grove Middle School	m.0761zkw	FAC
Action Congress of Nigeria	m.027klm7	ORG
Great Library of Alexandra	m.04h7_	FAC
Servicio Mundial de la BBC	m.09cz5	ORG
communist party of ukraine	m.026xk6	ORG
united states armed forces	m.07xg1	ORG
Agencia Judía para Israel	m.01k38p	ORG
quartet on the middle east	m.06f_09	ORG
Congreso de Estados Unidos	m.07t31	ORG
German Democratic Republic	m.03f2w	GPE
the washington free beacon	m.0j9pbdl	ORG
Muhammad ibn Abd-al-Wahhab	m.050jw	PER
united nations secretariat	m.015kq0	ORG
Mar de la China Meridional	m.0jtm8	LOC
Partido de los 50 centavos	m.05b52_k	ORG
Jacqueline Bouvier Kennedy	m.0h6mq	PER
Sistema de Reserva Federal	m.02xmb	ORG
Majles Shura al-Mujahideen	m.027x630	ORG
the new york times company	m.07l1c	ORG
Parlamento del Reino Unido	m.03mkh	ORG
Congreso Nacional Africano	m.0_00	ORG
people united means action	m.04cqmpj	ORG
Corte Penal Internacional	m.03v8k	ORG
Clinton Global Initiative	m.06505ml	ORG
Hospital clínico central	m.02r02xk	FAC
Fuerzas Armadas iraquíes	m.0bwgs3w	ORG
National Security Council	m.0c0bf	ORG
gibson guitar corporation	m.01chbr	ORG
Yihad Islámica Palestina	m.0kwxh	ORG
Miguel Angel Osorio Chong	m.026drw7	PER
Asamblea Federal de Rusia	m.04nr2w	ORG
African National Congress	m.0_00	ORG
Prosecutor General Office	m.08hxyr	ORG
Muro de las Lamentaciones	m.0j_pp	FAC
Oficina de la Presidencia	m.01p1kp	ORG
Universidad de Georgetown	m.0pspl	ORG
all progressives congress	m.0r4k3hv	ORG
tehrik-i-taliban pakistan	m.04jhbb_	ORG
warner bros entertainment	m.086k8	ORG
Great Moskvoretsky Bridge	m.0285n2c	FAC
The Sydney Morning Herald	m.01m57l	ORG
ibrahim haji jama mee'aad	m.0gfhw2l	PER
Cámara de Representantes	m.0b3wk	ORG
Bruno Rodríguez Parrilla	m.03nrgcm	PER
Cámara de representantes	m.0b3wk	ORG
people's democratic party	m.0276bn	ORG
Biblioteca de Alejandría	m.04h7_	FAC
National Iranian American	m.0c5xyj	ORG
Universidad de Nueva York	m.0bwfn	ORG
Partido Comunista Iraquí	m.033jb5	ORG
World Health Organization	m.0840w	ORG
All Progressives Congress	m.0r4k3hv	ORG
National Security Archive	m.04fvjf	ORG
American Camp Association	m.0886ns	ORG
Partido Comunista de Cuba	m.023tjr	ORG
Gibson Guitar Corporation	m.01chbr	ORG
Revolutionary Guard Corps	m.04q3gn	ORG
Tehrik e Taliban Pakistan	m.04jhbb_	ORG
Clinton Family Foundation	m.0fqw_s	ORG
Umar Farouk Abdulmutallab	m.0b6fdr1	PER
Departamento de Seguridad	m.044s96	ORG
Consejo de Estado de Cuba	m.087r3g	ORG
Isabel II del Reino Unido	m.0d1_f	PER
umar farouk abdulmutallab	m.0b6fdr1	PER
United States of America	m.09c7w0	GPE
Internal Revenue Service	m.03z19	ORG
Mancomunidad de Naciones	m.0j7v_	ORG
New York Review of Books	m.01rdhr	ORG
China Railway High-speed	m.027qp3j	FAC
Estados Unidos Mexicanos	m.0b90_r	GPE
Gulf Cooperation Council	m.01g87g	ORG
Universidad de Hong Kong	m.01nmgc	ORG
Félix Ismael Rodríguez	m.02zpns	PER
RIU Hotels &amp; Resorts	m.05dm4t	ORG
united states of america	m.09c7w0	GPE
the New American Century	m.01c4wz	ORG
Cuenca del Mediterráneo	m.07f7z7	LOC
All Progressive Congress	m.0r4k3hv	ORG
jane's information group	m.0458zs	ORG
Angélica Rivera de Pe?a	m.02vldw4	PER
Westgate shopping center	m.0xnxm0n	FAC
united states navy seals	m.09j2x	ORG
interdisciplinary center	m.09wn13	ORG
ISLAMIC Republic of Iran	m.03shp	GPE
Nigerian Bar Association	m.0b77f98	ORG
muhammad saeed al-sahhaf	m.01ctw_	PER
Fuerzas Armadas de Siria	m.06vfn	ORG
nigerian bar association	m.0b77f98	ORG
Syrian Government Forces	m.06vfn	ORG
Stephens investment firm	m.0gpgk6	ORG
Nigerian Bar association	m.0b77f98	ORG
National Security Agency	m.05htt	ORG
Barrett Firearms Company	m.02gd_l	ORG
federal security service	m.0225tg	ORG
Peoples Democratic Party	m.0276bn	ORG
Muhammad ibn Abdulwahhab	m.050jw	PER
Club Atlético de Madrid	m.0lg7v	ORG	NAM
Museo Nacional del Bardo	m.047prs0	FAC
internal revenue service	m.03z19	ORG
Ejército Libre de Siria	m.0h3xpcx	ORG
Fox Broadcasting Company	m.0cjdk	ORG
Galería de las Pinturas	m.0p88j	FAC
Universidad de San Diego	m.02rky4	ORG
jewish agency for israel	m.01k38p	ORG
Chelsea Victoria Clinton	m.01chwz	PER
Union of ISLAMIC Courts	m.0dlrbn	ORG
Doctors Without Borders	m.054p6	ORG
stephenville courthouse	m.06_93ph	FAC
St Ronald of The Reagan	m.06c0j	PER
Cabo de Buena Esperanza	m.0c1y3	GPE
Tumba de los Patriarcas	m.0jxp0	FAC
Fox Entertainment Group	m.02mp92	ORG
Península de Kamchatka	m.0326hv	LOC
palestinian territories	m.0nyg5	LOC
Amnistía Internacional	m.012l0	ORG
Frank-Walter Steinmeier	m.089zlv	PER
Standard Chartered Bank	m.02hszk	ORG
Goodluck Ebele Jonathan	m.098v21	PER
The Dallas Morning News	m.02bd3p	ORG
prime minister's office	m.0cc7t_g	ORG
world trade center site	m.0hpjf	FAC
the walt disney company	m.09b3v	ORG
Islamic State’ (ISIS)	m.027x630	ORG
labour party of ukraine	m.03cb705	ORG
Liverpool Football Club	m.04ltf	ORG	NAM
communist party of cuba	m.023tjr	ORG
Syrian Arab News Agency	m.03b_7cq	ORG	NAM
Western Cape High Court	m.0b6n6c0	ORG
Emiratos Árabes Unidos	m.0j1z8	GPE
investigative committee	m.0g9x775	ORG
Universidad de Columbia	m.01w5m	ORG
Deutsche Presse-Agentur	m.04_l88	ORG
The Wall Street Journal	m.017b3j	ORG
Catedral de San Basilio	m.014lft	FAC
China Southern Airlines	m.021v2j	ORG
American Stock Exchange	m.0q6y	ORG
national health service	m.01fw9h	ORG
Ministerio del Interior	m.0dy22	ORG
U.S. Justice Department	m.0dtj5	ORG
Universidad de Pretoria	m.02c4fw	ORG
George A. O’Toole Jr.	m.05p1f_5	PER
erath county courthouse	m.06_93ph	FAC
islamic azad university	m.08gby7	ORG
Comité de Instrucción	m.0g9x775	ORG
Oeste de Estados Unidos	m.018hr_	LOC
Copa Mundial de Fútbol	m.030q7	ORG
The Walt Disney Company	m.09b3v	ORG
Liga de Estados Árabes	m.0dv0g	ORG	NAM
fox entertainment group	m.02mp92	ORG
Ocean Park de Hong Kong	m.04_n5l	FAC
Internacional Comunista	m.01jr72	ORG
alan fonteles oliveira	m.0h54tx3	PER
Palacio de Westminster	m.060yf	FAC
Independent Television	m.0fxqm	ORG
united states congress	m.07t31	ORG
Médicos Sin Fronteras	m.054p6	ORG
downtown Oklahoma City	m.02rplr5	LOC
Institución Brookings	m.01x7wr	ORG
baghdad central prison	m.02y6f3	FAC
Departamento de Estado	m.07vsl	ORG
Gobernación de Aleppo	m.0261xzh	GPE
Aerolíneas Argentinas	m.0ln7k	ORG
Kentucky Fried Chicken	m.09b6t	ORG
Columbiana Centre mall	NIL10009	FAC
allies of world war ii	m.06v9sf	ORG
kathleen moira carroll	m.0vs4jbf	PER
Territorios Palestinos	m.0nyg5	LOC
anti-defamation league	m.0q442	ORG
High Court in Pretoria	m.05v8dt6	ORG
Archipiélago japonés	m.034v8g	LOC
Abadía de Westminster	m.0bvqq	FAC
Verizon Communications	m.07_dn	ORG
Federal District Court	m.06hgjl	FAC
westgate shopping mall	m.0xnxm0n	FAC
Universidad de Nairobi	m.0820xz	ORG
ministerio de Interior	m.0dy22	ORG
federal reserve system	m.02xmb	ORG
departamento de Estado	m.07vsl	ORG
al-itihaad al-islamiya	m.0dmp1n	ORG
Ejército Árabe Sirio	m.04n7jf6	ORG
Península de Yucatán	m.04lzs8	LOC
PEN Club Internacional	m.03v1l6	ORG
Campo Base del Everest	m.0gzlc2	ORG
Universidad de Panamá	m.026lkmb	ORG
1600 Pennsylvania Ave.	m.081sq	FAC
China Eastern Airlines	m.02r61q	ORG
Hillary Rodham Clinton	m.0d06m5	PER
national disaster body	m.0gmf7ck	ORG
University of Pretoria	m.02c4fw	ORG
Fútbol Club Barcelona	m.0hvgt	ORG
Basílica de San Pedro	m.0jnym	FAC
Helle Thorning-Schmidt	m.05rn5r	PER
Prisión de Abu Ghraib	m.02y6f3	FAC
cave of the patriarchs	m.0jxp0	FAC
democratic underground	m.02dwm8	ORG
Gran Salón del Pueblo	m.02p9ts	FAC	NAM
hillary rodham clinton	m.0d06m5	PER
Cámara de los Comunes	m.03ljr	ORG
georgetown university	m.0pspl	ORG
Levante mediterráneo	m.04l_r	LOC
ex-Secretary of State	m.0d06m5	PER
Bardo National Museum	m.047prs0	FAC
Península del Sinaí	m.06wjy	LOC
abu mansoor al-amriki	m.06w927x	PER
the mcclatchy company	m.03y7ml	ORG
priorities usa action	m.0k881sg	ORG
ulster unionist party	m.0j8cs	ORG
Banco Central Europeo	m.02l6_	ORG
Ejército Libre Sirio	m.0h3xpcx	ORG
Recep Tayyip Erdoğan	m.021275	PER	NAM
Franklin D. Roosevelt	m.02yy8	PER
Palacio de Buckingham	m.0198g	FAC
Universidad de Pekín	m.0jhjl	ORG
Mohamad Emami-Kashani	m.027cy8f	PER
Relaciones Exteriores	m.02qh6rs	ORG
Región de Canterbury	m.0gs0w	GPE
peter godsday orubebe	m.0brz_r2	PER
Provincia Nororiental	m.04zwlb	GPE
Bahía de Guantánamo	m.0btt37	LOC
brookings institution	m.01x7wr	ORG
Defenders of Wildlife	m.0b9csz	ORG
Priorities USA Action	m.0k881sg	ORG
united states capitol	m.07vth	FAC
Jewish Defense League	m.0466w	ORG
western united states	m.018hr_	LOC
Mar de China Oriental	m.018smn	LOC
servicio de seguridad	m.0225tg	ORG
Jorge Mario Bergoglio	m.05ngt2	PER
Big New-Moskva Bridge	m.0285n2c	FAC
Hemisferio occidental	m.0jntd	LOC
Jose Posada Carrilles	m.05s3hb	PER
amnesty international	m.012l0	ORG
Iglesia de Inglaterra	m.01spm	ORG
Palacio de Miraflores	m.05frbv	FAC
Península balcánica	m.01jjk	LOC
Gran Puente de Piedra	m.09d88g	FAC
Hemisferio Occidental	m.0jntd	LOC
Abu Mansoor Al-Amriki	m.06w927x	PER
ministro del Interior	m.0dy22	ORG
Human Rights Campaign	m.01xcy2	ORG
European Central Bank	m.02l6_	ORG
US military personnel	m.07xg1	ORG
Petro Poroshenko Bloc	m.06f981	ORG
Freedom and Democracy	m.06w22tt	ORG
Napoleón I Bonaparte	m.0j5b8	PER	NAM
Euskadi Ta Askatasuna	m.02pvw	ORG
University of Nairobi	m.0820xz	ORG
U.S. State Department	m.07vsl	ORG
Monarquías del Golfo	m.08qmn6	LOC
National Bardo Museum	m.047prs0	FAC
Department of Defense	m.07y0n	ORG
human rights campaign	m.01xcy2	ORG
Universidad Bar Ilán	m.02l2yf	FAC
Gobernación de Alepo	m.0261xzh	GPE	NAM
The Coca-Cola Company	m.03phgz	ORG
Hossein Shariatmadari	m.06cz25	PER
Islas Turcas y Caicos	m.07fr_	LOC
Armada estadounidense	m.07xg1	ORG
Universidad de Oxford	m.07tgn	ORG
presidential offices	m.02pqlxb	FAC
Cámara de los Lores	m.03k6x	ORG
al-ittihad al-islami	m.0dmp1n	ORG
Abu Bakr Al-Bagdadhi	m.0h7q0rq	PER
Alexander Lukashenko	m.014kb2	PER	NAM
Bosnia y Herzegovina	m.0166b	GPE
Kgosi Mampuru prison	m.0gvr1cs	FAC
Liga Antidifamación	m.0q442	ORG
Gulf Oil Corporation	m.0g47q	ORG
Hacettepe University	m.047s3b	ORG
Ejército de Beiyang	m.03fg7s	ORG
Islamic Courts Union	m.0dlrbn	ORG
times newspapers ltd	m.09mcc9n	ORG
república islámica	m.03shp	GPE
Luis Posada Carriles	m.05s3hb	PER
royal jordanian army	m.0dl88_	ORG
Tomás Estrada Palma	m.03btyl	PER
Provincia de Limpopo	m.01_zrk	GPE
greentech automotive	m.0sghmt8	ORG
mohammed adamu bello	m.09gddy9	PER
Provincia de Cantón	m.0h9vh	GPE
District of Columbia	m.0rh6k	GPE
United States Senate	m.07t58	ORG
Israel nuestro hogar	m.05kcg7	ORG
islamic courts union	m.0dlrbn	ORG
Mare Tranquillitatis	m.01cmw3	LOC
Syrian Golan Heights	m.03cdz	LOC
dzhokhar a. tsarnaev	m.0t4r0zs	PER
Texas State Cemetery	m.092yjl	FAC
british armed forces	m.07sx7	ORG
Universidad Tsinghua	m.0jksm	ORG
Pretoria Boys School	m.071jjx	FAC
Abu Bakr al Baghdadi	m.0h7q0rq	PER
macmillan publishers	m.041f8t	ORG
Guangzhou Evergrande	m.0287xhr	ORG	NAM
St Basil's Cathedral	m.014lft	FAC
maria corina machado	m.0f4rwv	PER
República Islámica	m.03shp	GPE
BARACK HUSSEIN OBAMA	m.02mjmr	PER
Provincia de Taiwán	m.0hm2s	GPE
united states senate	m.07t58	ORG
Slobodan Milošević	m.075jp	PER
United Arab Emirates	m.0j1z8	GPE
rough creek crossing	m.04bxyzx	LOC
joseph ole nkaissery	m.047nmm5	PER
The State Department	m.07vsl	ORG
Condado de Baltimore	m.0cv0r	GPE
Barack Hussein Obama	m.02mjmr	PER
Mijaíl Kaláshnikov	m.04y1b	PER
Abdulsalami Abubakar	m.03k4gk	PER
Real Betis Balompié	m.03fnqj	ORG
Abu Bakr Al-Baghdadi	m.0h7q0rq	PER
occupied territories	m.0nyg5	LOC
Mohammad Javad Zarif	m.0c1pjf	PER
Consejo de Seguridad	m.0c0bf	ORG
Óblast de Nóvgorod	m.02d_54	GPE
Universidad Anáhuac	m.02746k8	FAC
Hong Kong Disneyland	m.022zvr	FAC
República del Congo	m.01rxw	GPE
hacettepe university	m.047s3b	ORG
Friends of the Earth	m.0c1h5	ORG
Aleksandr Litvinenko	m.026ndjg	PER
ann carey mcfeatters	m.0c3s1z5	PER
Agence France-Presse	m.02dlk9	ORG
St. Peter's Basilica	m.0jnym	FAC
Ejército de Nigeria	m.0cny569	ORG
agence france-presse	m.02dlk9	ORG
Mohammad Yavad Zarif	m.0c1pjf	PER
Seattle City Council	m.03yp65	ORG
The Associated Press	m.0cv_2	ORG
partido republicano	m.07wbk	ORG
ejército nigeriano	m.0cny569	ORG
mediterranean basin	m.07f7z7	LOC
US State Department	m.07vsl	ORG
Península de Corea	m.01krx6	LOC
the hershey company	m.0lq_7	ORG
Distrito Financiero	m.029g2t	FAC
Presidente de Rusia	m.01jrl6	ORG
Army Special Forces	m.01vf1h	ORG
Universidad Rutgers	m.0ks67	ORG
bar-ilan university	m.02l2yf	FAC
southern california	m.0gx1l	LOC
Subcontinente indio	m.019v3t	LOC
F. Scott Fitzgerald	m.02zjd	PER
Ciudad del Vaticano	m.07ytt	GPE
Archivos Nacionales	m.03w726n	FAC
Hermanos Musulmanes	m.056rs	ORG
sunlight foundation	m.0fwnhk	ORG
Jerusalén Oriental	m.01yf2v	LOC
UN Security Council	m.07vnr	ORG
Mijaíl Jodorkovski	m.01rr8_	PER
president of russia	m.01jrl6	ORG
Pretoria High Court	m.05v8dt9	ORG
Luiz Felipe Scolari	m.0389yd	PER	NAM
Distrito de Huangpu	m.03gvz0c	GPE
the huffington post	m.0hmrpgb	ORG
Lawrence J. Ellison	m.01762z	PER
Yingluck Shinawatra	m.0gtw43g	PER	NAM
República de China	m.06f32	GPE
treasury department	m.0f1r9	ORG
Anna Politkóvskaya	m.05gg5b	PER
european parliament	m.02m0v	ORG
Virginia Occidental	m.081mh	GPE
Wall Street Journal	m.017b3j	ORG
Al Jazeera América	m.0pdbv90	ORG
the washington post	m.0px38	ORG
Luis Miguel Barbosa	m.0x13hv_	PER
Benjamín Netanyahu	m.0fm2h	PER
Autoridad Palestina	m.0604m	ORG
Stanislav Markélov	m.05c3_xr	PER
Natalia Estemírova	m.06zsvc2	PER
Abu Bakr Al Bagdadi	m.0h7q0rq	PER
Condado de Pinellas	m.0jxgx	GPE
Mezquita de Al-Aqsa	m.0hfk1	FAC
Sanfrecce Hiroshima	m.04d8k5	ORG
Partido Conservador	m.07wpm	ORG
Víktor Yúshchenko	m.0465w3	PER
Metro-Goldwyn-Mayer	m.0g1rw	ORG
Amigos de la Tierra	m.0c1h5	ORG
the weekly standard	m.01d6m_	ORG
Universidad de Kiev	m.05d9y_	ORG
Estrecho de Taiwán	m.0mlsw	LOC
José Antonio Meade	m.0wykx8x	PER
Víktor Yanukóvich	m.023115	PER
Estado de Palestina	m.01k0p4	GPE
The Washington Post	m.0px38	ORG
Credit Suisse Group	m.03g776	ORG
rpr-parnassus party	m.0642d9w	ORG
Palacio del Elíseo	m.01vfbv	FAC
U.S. District Court	m.0j75z	ORG
Americansnipers.org	m.05b551	ORG
Cristina Fernández	m.05k5_1	PER
Department of State	m.07vsl	ORG
Aeropuerto Heathrow	m.03jn4	FAC
Aymán al Zawahirí	m.01vcb_	PER
New York University	m.0bwfn	ORG
Castillo de Windsor	m.0chgsm	FAC
Región del Darién	m.02833_	LOC
Christopher Stevens	m.0n46_gt	PER
Canal de Mozambique	m.053jv	LOC	NAM
Alemania Occidental	m.082fr	GPE
Banco Popular Chino	m.0d1lb	ORG
Víctor Yanukóvich	m.023115	PER
Jean-Luc Mélenchon	m.04zzm99	PER
Chevron Corporation	m.01pvx3	ORG
Ejército nigeriano	m.0cny569	ORG
Universidad Harvard	m.03ksy	ORG
Universidad Clemson	m.012vwb	ORG
Comisión Electoral	m.02q2wn5	ORG
John D. Rockefeller	m.019g80	PER
University of Texas	m.07w0v	ORG
Hospital de Banadir	m.0h7q143	FAC
Canal de la Mancha	m.02j7k	LOC
ford motor company	m.02zs4	ORG
Plaza de San Pedro	m.03mj05	LOC
Levi Strauss & Co.	m.02j46m	ORG
St. Leo University	m.02ws5h	ORG
Chrysler Group LLC	m.01_bp	ORG
Kurdistán iraquí	m.0329by	LOC
Harvard Law School	m.014zws	ORG
Paramount Pictures	m.05qd_	ORG
América del Norte	m.059g4	LOC
Commander in Chief	m.02mjmr	PER
Whole Foods Market	m.02xf2l	FAC
michael dean crapo	m.021pgp	PER
Berkshire Hathaway	m.01tmng	ORG
iraqi armed forces	m.0bwgs3w	ORG
Joseph Zen Ze-kiun	m.039rk1	PER
united states army	m.07wh1	ORG
Christian Goldbach	m.01w1b	PER
Hassan Dahir Aweys	m.0d_tlz	PER
Bolsa de San Pablo	m.04_kd2	ORG
financial district	m.029g2t	FAC
disuniter in chief	m.0d06m5	PER
Clemson University	m.012vwb	ORG
François Hollande	m.02qg4z	PER
Los Angeles Lakers	m.0jmk7	ORG	NAM
Restore Our Future	m.0h3vvjt	ORG
aleppo governorate	m.0261xzh	GPE
secretary of state	m.0d06m5	PER
Partido Socialista	m.01qdcv	ORG
Condado de Navarro	m.0mqm3	GPE
Partido Demócrata	m.0d075m	ORG
Palacio del Senado	m.02pqlxb	FAC
Benjamin Netanyahu	m.0fm2h	PER
Theodore Kaczynski	m.07lvn	PER
Gran Muralla China	m.0d2dq0	FAC
abu hamza al-masri	m.018dpq	PER
Abu Hamza al-Masri	m.018dpq	PER
José Narro Robles	m.03cytd4	PER
chrysler group llc	m.01_bp	ORG
Bolsa de Shanghái	m.04xjz4	ORG
Europa continental	m.01r_1	LOC
rutgers university	m.0ks67	ORG
John Birch Society	m.01hnmy	ORG
Bahía de Cochinos	m.0d86w	LOC
partido demócrata	m.0d075m	ORG
The Times Magazine	m.09rkd	ORG
nalanda university	m.04gsq29	ORG
world trade center	m.083_h	FAC
conservative party	m.07wpm	ORG
China del Noroeste	m.09dq32	LOC
xinhua news agency	m.01n13b	ORG
sub-saharan africa	m.06qtn	LOC
harvard university	m.03ksy	ORG
Martin Luther King	m.051cc	PER
justice department	m.0dtj5	ORG
Cuarteto de Madrid	m.06f_09	ORG
Madeleine Albright	m.0_5vr	PER
St. Peter's Square	m.03mj05	LOC
Santuario Yasukuni	m.01mr7p	FAC
República de Daud	m.02hjn	GPE
united states navy	m.07wg3	ORG
José María Aznar	m.01c29s	PER
Océano Atlántico	m.0j3b	LOC
Human Rights Watch	m.0ckxt	ORG
Federación Malaya	m.01s8rk	GPE
Política Exterior	m.03c91_q	ORG
Theodore Roosevelt	m.07hyk	PER
Secretary of State	m.0d06m5	PER
Estados Americanos	m.07c5l	LOC
US Central Command	m.01xsrd	ORG
John Bellinger III	m.09rhg2	PER
World Trade Center	m.083_h	FAC
continental europe	m.01r_1	LOC
Bolsa de Hong Kong	m.0219xl	ORG
Mahmud Ahmadineyad	m.06dsyb	PER
presidential villa	m.07h407	FAC
The New York Times	m.07k2d	ORG
al jazeera america	m.0pdbv90	ORG
Juventus de Turín	m.045xx	ORG	NAM
whole foods market	m.02xf2l	FAC
África Occidental	m.0hqjh	LOC
Ford Motor Company	m.02zs4	ORG
Tea Party Movement	m.09v571r	ORG
clinton foundation	m.0fqw_s	ORG
defense department	m.07y0n	ORG
federal courthouse	m.06hgjl	FAC
alan phillip gross	m.0gh8r7s	PER
Southern Democrats	m.03j8_g	ORG
Congreso de EE.UU.	m.07t31	ORG
Carolina del Norte	m.05fkf	GPE
Sea of Tranquility	m.01cmw3	LOC
Seguridad Nacional	m.0fmtw3	ORG
provincia de Anbar	m.02czqj	GPE
Edward O'Callaghan	m.0_ynsvt	PER
Prospekt de Moscú	m.0df3l8	FAC
Cúpula de la Roca	m.0hf9d	FAC
muslim brotherhood	m.056rs	ORG
tea party movement	m.09v571r	ORG
Parlamento Europeo	m.02m0v	ORG
Lista árabe Unida	m.04p7xc	ORG
Imperio británico	m.01hnp	GPE
Government of Cuba	m.0d04z6	GPE
Cristóbal Colón	m.01pwz	PER
Gerhard Schröder	m.0bj7n	PER
Rough Creek Ranch	m.0gswpw	LOC
Kremlin de Moscú	m.021lry	FAC
Malaysia Airlines	m.013_0l	ORG
Partido Laborista	m.0207yf	ORG
Bolsa de Shenzhen	m.01w_6l	ORG
Irlanda del Norte	m.05bcl	GPE
arabian peninsula	m.0cvmv	LOC
Mongolia Interior	m.0fbks	GPE	NAM
China continental	m.0fbp0	LOC
Partido comunista	m.097ck	ORG
tana river county	m.098gc4	GPE
nikon corporation	m.03pmfw	ORG
pakistani taliban	m.04jhbb_	ORG
Royal Dutch Shell	m.0g5vy	ORG
Océano Pacífico	m.05rgl	LOC
Intel Corporation	m.03s7h	ORG
Jesús de Nazaret	m.045m1_	PER
The Baltimore Sun	m.01n0qv	ORG
Petró Poroshenko	m.08w60w	PER
Avigdor Lieberman	m.05psm_	PER
Juegos Olímpicos	m.05nd_	ORG
Fulgencio Batista	m.0d927	PER
wellesley college	m.017v71	ORG
BBC World Service	m.09cz5	ORG
US District Court	m.0j75z	ORG
moktar ali zubeyr	m.06w2bxg	PER
Iglesia católica	m.02vxy_	ORG
Santiago de Chile	m.0dlqv	GPE
Fran?ois Hollande	m.02qg4z	PER
electoral college	m.0lq3t	ORG
Goodluck Jonathan	m.098v21	PER
Ciudad de México	m.04sqj	GPE
Alberto Bailleres	m.07lpst	PER
Federico Lombardi	m.03h158x	PER
Otto von Bismarck	m.05m0_	PER
Juan R. Torruella	m.086q3r	PER
ibadan south-west	m.09gflrq	GPE
Universidad Fudan	m.0jktd	ORG
john walker lindh	m.0469p	PER
ejército iraquí	m.0bwgs3w	ORG
Sudeste Asiático	m.073q1	LOC
Christine Lagarde	m.027xqz7	PER	NAM
inspector general	m.02r52hq	ORG
Dzhokhar Tsarnaev	m.0t4r0zs	PER
Consejo de Europa	m.01rz1	ORG	NAM
Ixtapan de la Sal	m.03cyscv	GPE
Margaret Thatcher	m.03f5vvx	PER
Cuerno de África	m.0gt8x	LOC
Unión Soviética	m.05vz3zq	GPE
The United States	m.09c7w0	GPE
Henrique Capriles	m.0gyd4y	PER
Abd al-Bari Atwan	m.08q2cq	PER
Ahmed Abdi Godane	m.06w2bxg	PER
Diario del Pueblo	m.01n12w	ORG
iglesia católica	m.02vxy_	ORG
Mijaíl Gorbachov	m.058md	PER
amazon rainforest	m.0cx4p	LOC
sikorsky aircraft	m.01ncxn	ORG
Franz Beckenbauer	m.013xhr	PER
Asamblea Nacional	m.02j_vd	ORG
Alianza del Norte	m.025s76x	ORG
Pirámide de Jufu	m.036mk	FAC
Maiduguri Airport	m.0281fkx	FAC
onevoice movement	m.0281xb9	ORG
the Islamic State	m.027x630	ORG
southwestern bell	m.01y1jl	ORG
Sur de California	m.0gx1l	LOC
Europa Occidental	m.0852h	LOC
Ready for Hillary	m.0_fts1x	ORG
Wellesley College	m.017v71	ORG
George H. W. Bush	m.034ls	PER
Palacio de Vidrio	m.019vsd	FAC
Angélica Fuentes	m.0ddb7bt	PER
Annapurna Circuit	m.0glqysw	LOC
Cristina Kirchner	m.05k5_1	PER
american military	m.07xg1	ORG
fox entertainment	m.02mp92	ORG
Straits of Hormuz	m.075t9	LOC
Asiaweek Magazine	m.065cpq	ORG
Estrecho de Ormuz	m.075t9	LOC
Sebastián Pi?era	m.064095	PER
Condado de Parmer	m.0mqhr	GPE
George Washington	m.034rd	PER
Metropolitan Club	m.04q02kb	ORG
associated press	m.0cv_2	ORG
northern ireland	m.05bcl	GPE
democratic party	m.0d075m	ORG
InterCityExpress	m.019jhp	ORG
América del Sur	m.06n3y	LOC
Angélica Rivera	m.02vldw4	PER
Internet Society	m.01cwsb	ORG
Altos del Golán	m.03cdz	LOC
Estado Islámico	m.027x630	ORG
Fars News Agency	m.0cz72k	ORG
Big foot Wallace	m.089jkj	PER
lefortovo prison	m.027jynl	FAC
Jorge Rodríguez	m.027h_8g	PER
Diosdado Cabello	m.0d2d3	PER
Puerto Elizabeth	m.06f0y3	GPE
República Jemer	m.0661mx9	GPE
hanseatic league	m.03nnt	ORG
Grandes Llanuras	m.0dkwn	LOC
Neftalí Bennett	m.0g9z94d	PER
Papa Francisco I	m.05ngt2	PER
Henrique Cardoso	m.0l5d3	PER
security council	m.07vnr	ORG
Condado de Ellis	m.0mrwx	GPE
Adelbert Waldron	m.02rb0jk	PER
constantia kloof	m.04ys3c	LOC
Región báltica	m.01xrc5	LOC
Santiago de Cuba	m.01j4rs	GPE
Chiang Ching-kuo	m.0gljh	PER	NAM
northern nigeria	m.0cv_2	ORG
Nizhni Nóvgorod	m.0hclr	GPE
social democrats	m.01qdcv	ORG
Soong Ching-ling	m.01d086	PER
The New Republic	m.01mqw1	ORG
aleppo governate	m.0261xzh	GPE
Condado de Erath	m.0mrwj	GPE
joint base balad	m.0d7vjv	FAC
Nueva Inglaterra	m.029jpy	GPE
Alekséi Navalny	m.0dlllc6	PER
estado Islámico	m.027x630	ORG
voice of america	m.0q0r9	ORG
Associated Press	m.0cv_2	ORG
Estado islámico	m.027x630	ORG
Abdel Bari Atwan	m.08q2cq	PER
Felipe González	m.01n_zs	PER
George O’Toole	m.05p1f_5	PER
Zhū Yuánzhāng	m.015nm9	PER
África Oriental	m.01mqb6	LOC
police of russia	m.0gg6v7b	ORG
ibadan southwest	m.09gflrq	GPE
David O. Russell	m.06m6z6	PER
Alina Fernández	m.057vff	PER
Arseni Yatseniuk	m.02q86vg	PER
República Checa	m.01mjq	GPE
Al Qaeda en Iraq	m.02r3wy1	ORG
Google for Voice	m.02q0knk	ORG
Oriente Próximo	m.04wsz	LOC
Mónica Lewinsky	m.0509p	PER
Council of State	m.013xx3	ORG
The Boston Globe	m.07dk8	ORG
iglesia catolica	m.02vxy_	ORG
republican party	m.07wbk	ORG
Dianne Feinstein	m.01gqws	PER
América Del Sur	m.06n3y	LOC
George H.W. Bush	m.034ls	PER
john coffee hays	m.07zcgr	PER
Nikita Jrushchov	m.0bphp	PER
fox news channel	m.02z_b	ORG
Ramzán Kadýrov	m.02_bnb	PER
Norte de África	m.05g2v	LOC
Franklin B. Roof	NIL10003	PER
óscar Pistorius	m.0f1lfn	PER
Washington D. C.	m.0rh6k	GPE
Red Army Faction	m.06gt7	ORG
La Muerte Blanca	m.0250qs	PER
condado de Erath	m.0mrwj	GPE
Hemisferio norte	m.05k3k	LOC
Andrés Pastrana	m.02jv0y	PER
the student room	m.09glgr	ORG
Aung San Suu Kyi	m.011p3	PER
Liga Hanseática	m.03nnt	ORG
Empresa pública	m.01d1z6	ORG
Free Syrian Army	m.0h3xpcx	ORG
John Coffee Hays	m.07zcgr	PER
William McKinley	m.083p7	PER
Juventus Stadium	m.05qbb5p	FAC	NAM
state department	m.07vsl	ORG
the boston globe	m.07dk8	ORG
Djokhar Tsarnaev	m.0t4r0zs	PER
british military	m.07sx7	ORG
graeme c.a. wood	m.0nd2yj3	PER
Tierra del Fuego	m.024vn9	GPE
James C. Goodale	m.09vzm2	PER
Condado de Pasco	m.0jryt	GPE
thomson holidays	m.08nm45	ORG
washington, d.c.	m.0rh6k	GPE
islamic republic	m.03shp	GPE
Universidad Yale	m.08815	ORG
Muamar el Gadafi	m.0dxvs	PER
Carolina del Sur	m.06yxd	GPE
Roberta Jacobson	m.0n5wkm6	PER
Europa del Norte	m.01531v	LOC
Dome of the Rock	m.0hf9d	FAC
aung san suu kyi	m.011p3	PER
Muhammadu Buhari	m.02p45h	PER
Al Qaeda in Iraq	m.02r3wy1	ORG
Baltimore Police	m.098sfc	ORG
Fox News Channel	m.02z_b	ORG
Steven Spielberg	m.06pj8	PER
central american	m.01tzh	LOC
Christopher Kyle	m.0hzrl7z	PER
Guardia de Honor	m.03wrck	ORG
América Central	m.01tzh	LOC
Chiang Kai-shek	m.01_4z	PER
Isla La Tortuga	m.0dlbk6	LOC
State of Israel	m.03spz	GPE
América Latina	m.04pnx	LOC
estadounidenses	m.09c7w0	GPE
Muro de Berlín	m.017f5	FAC
Carlos Hathcock	m.02jlx7	PER
Rucka Rucka Ali	m.080f5nb	PER
Unión Africana	m.0gkjy	ORG
Sandra L. Lynch	m.0dwdcv	PER
Steven Weinberg	m.01d63v	PER
citizens united	m.0129tn	ORG
Frente al Nusra	m.0j44g62	ORG
Hillary Clinton	m.0d06m5	PER
Jérôme Valcke	m.0cc7y43	PER
Oscar Pistorius	m.0f1lfn	PER
Asia Occidental	m.023ptn	LOC
umass dartmouth	m.023zrb	ORG
The Irish Times	m.012vh7	ORG
Nicolas Sarkozy	m.02ps9k	PER
San Petersburgo	m.06pr6	GPE
osama bin laden	m.05mg9	PER
Voz de América	m.0q0r9	ORG
northern europe	m.01531v	LOC
Joseph McCarthy	m.0455m	GPE
Harry S. Truman	m.09bg4l	PER
english channel	m.02j7k	LOC
sinai peninsula	m.06wjy	LOC
Michael Jackson	m.09889g	PER
Vladímir Putin	m.08193	PER
Leung Chun-ying	m.05drkz	PER
Desierto árabe	m.01cdln	LOC
huffington post	m.0hmrpgb	ORG
national report	m.0y6c_nd	ORG
weekly standard	m.01d6m_	ORG
AMéRICA LATINA	m.04pnx	LOC
eastern ukraine	m.0gy144c	LOC
Leopoldo López	m.0gxksy	PER
Mariano Recalde	m.0n55spp	PER
Estado de Lagos	m.02y31x	GPE
Mundo islámico	m.01b5kq	ORG
Anatoli Yakunin	m.0j_09j7	PER
Borís Nemtsvov	m.05fz6q	PER
Naciones Unidas	m.07t65	ORG
Royal Air Force	m.06dqt	ORG
Ciudad del Cabo	m.01yj2	GPE
Aden Hashi Ayro	m.027h681	PER
the irish times	m.012vh7	ORG
royal air force	m.06dqt	ORG
Elijah Cummings	m.025k9h	PER
Sidarta Gautama	m.015k7	PER
Steffen Seibert	m.0cmdtpq	PER
George Marshall	m.094rh	PER
Charles Chaplin	m.01lc5	PER
UNION SOVIETICA	m.05vz3zq	GPE
marathon sports	m.0swls1r	FAC
ulster unionist	m.0j8cs	ORG
Ram Baran Yadav	m.04f4sdc	PER
nobel committee	m.06ztth6	ORG
World Wild Fund	m.0829b	ORG
Hasán Rouhaní	m.06sx5v	PER
Getúlio Vargas	m.01djwt	PER
central america	m.01tzh	LOC
Reeva Steenkamp	m.0qtngg8	PER
Islas Paracelso	m.05v0k	GPE
Nicolás Maduro	m.0h7hb4	PER
the Free Beacon	m.0j9pbdl	ORG
Jerusalén Este	m.01yf2v	LOC
estado de Borno	m.06xjkq	GPE
ibrahimi mosque	m.0jxp0	FAC
Huffington post	m.0hmrpgb	ORG
Financial Times	m.0108kc	ORG
Michael B. Oren	m.06zn69	PER
Jyllands-Posten	m.08k_rv	ORG
norteamericanos	m.09c7w0	GPE
Abraham Lincoln	m.0gzh	PER
João Havelange	m.02s0__	PER
JP Morgan Chase	m.01hlwv	ORG
the White House	m.081sq	FAC
Donald Rumsfeld	m.02ddb	PER
OSCAR PISTORIUS	m.0f1lfn	PER
El hogar judío	m.04zxt7x	ORG
Océano Índico	m.03rz4	LOC
yale university	m.08815	ORG
Bashar Al Assad	m.01_vwx	PER
Superliga China	m.05sf_v	ORG
Houston Rockets	m.0jmfb	ORG	NAM
Bank of America	m.01yx7f	ORG
The Free Beacon	m.0j9pbdl	ORG
Osama Bin Laden	m.05mg9	PER
boylston street	m.027f7bt	LOC
Río de Janeiro	m.06gmr	GPE	NAM
Borís Nemstsov	m.05fz6q	PER
Antonio Ledezma	m.04zxyzm	PER
Banco de Suecia	m.06vk4	ORG
Europa oriental	m.09b69	LOC
Bahía de Tampa	m.02z4zg	LOC
Metro de Moscú	m.0hkhn	FAC
Europa Oriental	m.09b69	LOC
Ernesto Guevara	m.0d39k	PER
África Central	m.02n0ld	LOC
Monica Lewinsky	m.0509p	PER
the jewish home	m.04zxt7x	ORG
bacardi limited	m.01k6v	ORG
Naftali Bennett	m.0g9z94d	PER
american forces	m.07xg1	ORG
Corea del Norte	m.05b7q	GPE
kiev university	m.05d9y_	ORG
Washington D.C.	m.0rh6k	GPE
Dilma? Rousseff	m.026m5c8	PER
azad university	m.08gby7	ORG
estadounidences	m.09c7w0	GPE
communist party	m.023tjr	ORG
u.s. government	m.09c7w0	GPE
Osama bin Laden	m.05mg9	PER
John F. Kennedy	m.0d3k14	PER
Senado de Texas	m.03w950g	ORG
Bashar al Assad	m.01_vwx	PER
eastern siberia	m.025t91x	LOC
Treuhandanstalt	m.04vh2h	ORG
washington post	m.0px38	ORG
socialist party	m.01qdcv	ORG
Jay A. Pritzker	m.0f_dcz	PER
Bloque del Este	m.0p366	LOC
goldman sachses	m.01xdn1	ORG
Echo of Moscow	m.062bx3	ORG
Edward Snowden	m.0vzv0rq	PER
general motors	m.035nm	ORG
Unity of Islam	m.0dmp1n	ORG
eastern europe	m.09b69	LOC
Franja de Gaza	m.0357_	LOC
guantanamo bay	m.0c0llt	FAC
south florida.	m.0j7nh34	LOC
BBC World News	m.09cw9	ORG
moscow kremlin	m.021lry	LOC
Mireya Moscoso	m.022v9_	PER
Sergéi Lavrov	m.02n670	PER
General Motors	m.035nm	ORG
north carolina	m.05fkf	GPE
Earlewood Park	NIL10010	FAC
Michelle Obama	m.025s5v9	PER
PAPA FRANCISCO	m.05ngt2	PER
united nations	m.07t65	ORG
Chen Shui-bian	m.0fbn3	PER
Sudán del Sur	m.05rznz	GPE
kremlin senate	m.02pqlxb	FAC
maria conchita	m.01r1dcn	PER
estadounideses	m.09c7w0	GPE
Reino de Libia	m.02pv19h	GPE
north caucasus	m.02fsw8	LOC
Neil Armstrong	m.05b6w	PER	NAM
Borís Yeltsin	m.01krs	PER
John Schneider	m.01p8_0v	PER
central africa	m.02n0ld	LOC
rio de janeiro	m.06gmr	GPE
women's league	m.03ch85f	ORG
New York Times	m.07l1c	ORG
Baskin Robbins	m.01_k56	ORG
AMERICA LATINA	m.04pnx	LOC
Unión Europea	m.0_6t_z8	ORG
George O'Toole	m.05p1f_5	PER
Uhuru Kenyatta	m.02rm5w	PER
La Casa Judía	m.04zxt7x	ORG
Borís Nemtsov	m.05fz6q	PER
united kingdom	m.07ssc	GPE
windsor castle	m.0chgsm	FAC
Imperio mongol	m.01jv68	GPE
Isla de Borneo	m.01fzp	GPE
estadounidense	m.09c7w0	GPE
Quinta Avenida	m.01y5qy	LOC
atlantic ocean	m.0j3b	LOC
U.S. Navy SEAL	m.0hzrl7z	PER
MERCY Malaysia	m.043qv97	ORG
Trayvon Martin	m.0j5hpv8	PER
Abubakr Shekau	m.0j29dyf	PER
george w. bush	m.09b6zr	PER
Disney Channel	m.0kc9f	ORG
Denise Dresser	m.0f4v0w	PER
Papa Francisco	m.05ngt2	PER
Zhang Xueliang	m.089hk	PER
middle eastern	m.04wsz	LOC
Alexis Tsipras	m.03nqlcz	PER
National Guard	m.09gs3	ORG
Golfo Pérsico	m.0661z	LOC
golfo Pérsico	m.0661z	LOC
Horn of Africa	m.0gt8x	LOC
iraqi military	m.0bwgs3w	ORG
horn of Africa	m.0gt8x	LOC
Dunkin' Donuts	m.02ccc5	ORG
breitbart news	m.0k0symb	ORG
Lajdar Brahimi	m.02l9kb	PER	NAM
Dilma Rousseff	m.026m5c8	PER
Bachar al Asad	m.01_vwx	PER
Bill Clintoris	m.0157m	PER
Cecilia Cheung	m.05_dcr	PER
Patan Hospital	m.0495y0w	ORG
Jacques Chirac	m.09xg8	PER
navarro county	m.0mqm3	GPE
Clarence House	m.022ps7	FAC
Roy Chanderton	m.03qf4j	PER
Doble de Elvis	m.01r_2c	PER
parttimehuman2	m.0d05w3	GPE
east jerusalem	m.01yf2v	LOC
Bradley Cooper	m.01_xtx	PER
kenyon college	m.019c57	ORG
Banco Hapoalim	m.036yj8	ORG
Baruch College	m.02g0gf	ORG
Latinoamérica	m.04pnx	LOC
disney channel	m.0kc9f	ORG
thomas s grilk	m.03wvrt9	PER
Estados unidos	m.09c7w0	GPE
channel tunnel	m.01qnw	FAC
port elizabeth	m.06f0y3	GPE
Vladimir Putin	m.08193	PER
NICOLAS MADURO	m.0h7hb4	PER
Rupert Murdoch	m.06hrk	PER
Morgan Stanley	m.0jvs0	ORG
Cáucaso norte	m.02fsw8	LOC
Michael Phelps	m.03cvfg	PER	NAM
David Petraeus	m.08_hns	PER
Bernie Sanders	m.01_gbv	PER
George W. Bush	m.09b6zr	PER
Río Éufrates	m.02s22	LOC
Nelson Mandela	m.05g7q	PER
Laurent Fabius	m.01v7mn	PER	NAM
Islamic Centre	m.026mbg8	FAC
Joseph Blatter	m.0bl_l	PER
Cordillera Qin	m.045sfd	LOC
Balad Air Base	m.0d7vjv	FAC
Bloomberg L.P.	m.027sm6	ORG
Clint Eastwood	m.0bwh6	PER
Anders Breivik	m.0h1fpkg	PER
Cuenca Donéts	m.0372_h	GPE
Boston Red Sox	m.01d5z	ORG
Estados Unidos	m.09c7w0	GPE
northern irish	m.05bcl	GPE
Israel Beitenu	m.05kcg7	ORG
AT&T Southwest	m.01y1jl	ORG
baskin robbins	m.01_k56	ORG
Bolsa de Tokio	m.01b571	ORG	NAM
Islas Ryūkyū	m.01zy4q	LOC
gibson guitars	m.01chbr	ORG
estados unidos	m.09c7w0	GPE
strong ukraine	m.03cb705	ORG
sicilian mafia	m.05489	ORG
european union	m.0_6t_z8	ORG
King's College	m.014xf6	ORG
Medio Ambiente	m.02r11v8	ORG
Warren Buffett	m.01d_ys	PER
Arabia Saudita	m.01z215	GPE
latin american	m.04pnx	LOC
norteamericana	m.059g4	LOC
norteamericano	m.059g4	LOC
Ajmat Kadýrov	m.01rt1m	PER
Timor Oriental	m.02lx0	GPE
Michel Platini	m.01fdsm	PER
Alan Greenspan	m.015h4y	PER
u.s. route 287	m.028k8j	FAC
atlantic books	m.05qj6my	ORG
Hassan Rouhani	m.06sx5v	PER
Cáucaso Norte	m.02fsw8	LOC
Soong May-ling	m.072ln	PER	NAM
Middle-Eastern	m.04wsz	LOC
Islas Marshall	m.04v6v	GPE
Remington Arms	m.02jl8s	ORG
Saddam Hussein	m.079dy	PER
Attahiru Jega	m.0c3vtm3	PER
bilad airbase	m.0d7vjv	FAC
Mar de Ojotsk	m.0fwk0	LOC
african union	m.0gkjy	ORG
Banco Mundial	m.02vk52z	ORG
latinoamerica	m.04pnx	LOC
Confucianismo	m.01rkp	ORG
u.s. congress	m.07vth	FAC
Monte Everest	m.0blbd	LOC
Athletic Club	m.0kwv2	ORG	NAM
golan heights	m.03cdz	LOC
SUR AMERICANA	m.06n3y	LOC
David Kendall	m.02mr7f	PER
Tukur Buratai	NIL10002	PER
one direction	m.0fqqnpw	ORG
Nigerian Army	m.0cny569	ORG
north america	m.059g4	LOC
Jorge Arreaza	m.0rpgcnf	PER
new york city	m.02_286	GPE
kenyan police	m.0dw4p2	ORG
Reuven Rivlin	m.074knq	PER
Zhou Yongkang	m.061lnp	PER
Peter Neumann	m.05vdhcw	PER
east european	m.09b69	LOC
Nueva Zelanda	m.0ctw_b	GPE
Angela Merkel	m.0jl0g	PER
Kirguizistán	m.0jt3tjf	GPE
Theodor Herzl	m.0qlp_	PER
Corea del Sur	m.06qd3	GPE
Chicago Bulls	m.0jm74	ORG
bayelsa state	m.06xjhs	GPE
Iron Mountain	m.02rdq1m	ORG
Kate Mckinnon	m.03qcvwn	PER
Narendra Modi	m.0296q2	PER
pacific ocean	m.05rgl	LOC
Dmitri Peskov	m.0280k2k	PER
Actors Studio	m.01j390	ORG
Jomo Kenyatta	m.016zr6	PER
orlando magic	m.0jm4b	ORG
west virginia	m.081mh	GPE
Sadam Hussein	m.079dy	PER
Park Geun-hye	m.0760zn	PER
Alemania nazi	m.059z0	GPE
Chang Wanquan	m.047t2d9	PER	NAM
Islamic State	m.027x630	ORG
Islas Caimán	m.01nty	LOC
Despacho Oval	m.01hhz7	FAC
ThinkProgress	m.0h1c4mf	ORG
Diego García	m.02ddv	LOC
westgate mall	m.0xnxm0n	FAC
baltic region	m.01xrc5	LOC
olympic games	m.05nd_	ORG
El Pentágono	m.09w3b	FAC
Charlie Hebdo	m.06z90w	ORG
latin america	m.04pnx	LOC
Río Shebelle	m.02kwms	LOC
Al-Mahmudiyah	m.0f5b29	GPE
Richard Nixon	m.06c97	PER
Países Bajos	m.059j2	GPE
Wong Fei Hung	m.0sykn	PER
oklahoma city	m.0fvzg	GPE
The Economist	m.0dblm	ORG
Rose Law Firm	m.0532sf	ORG
Deutsche Bank	m.02lc8s	ORG
Duncan Taylor	m.09v56sq	PER
Orlando Magic	m.0jm4b	ORG
u.s. military	m.07xg1	ORG
supreme court	m.07sz1	ORG
united states	m.09c7w0	GPE
actors studio	m.01j390	ORG
Dinastía Han	m.0bx3d	GPE
drudge report	m.01dgg6	ORG
Tenzin Gyatso	m.01hw4n	PER
Paolo Maldini	m.012x9d	PER
Suramericanas	m.06n3y	LOC
Arabia Saudí	m.01z215	GPE
Canal de Suez	m.0783n	FAC
Seven Network	m.02h758	ORG
Oklahoma City	m.0fvzg	GPE
Islas Senkaku	m.01yzfk	LOC
Boris Nemtsov	m.05fz6q	PER
allied forces	m.06v9sf	ORG
Deutsche Bahn	m.01744t	ORG
Turkmenistán	m.01c4pv	GPE
south florida	m.0j7nh34	LOC
estadunidense	m.09c7w0	GPE
washington dc	m.0rh6k	GPE
Goldman Sachs	m.01xdn1	ORG
U.S. Congress	m.07vth	FAC
goldman sachs	m.01xdn1	ORG
Río Támesis	m.0d2kt	LOC
wesley snipes	m.02lymt	PER
Xinwen Lianbo	m.03bz06h	ORG
New York City	m.02_286	GPE
CORTE SUPREMA	m.03grc3	ORG
Austin Warner	m.074byn	PER
Head of State	m.03k4gk	PER
Jemeres rojos	m.04by4	ORG
O. J. Simpson	m.016mbz	PER
western world	m.020wr2	LOC
south african	m.0hzlz	GPE
south africas	m.0hzlz	GPE
Dinastía Qin	m.0bx3x	GPE
Iósif Stalin	m.03_lf	PER
Thomas Schaaf	m.08pcpk	PER
Latinoamerica	m.04pnx	LOC
Beijing Guoan	m.0dsfnd	ORG
Boris Nemstov	m.05fz6q	PER
Puente Moscú	m.0n49nvp	FAC
saudia arabia	m.01z215	GPE
Issa Tchiroma	m.07s7jdg	PER
Birch Society	m.01hnmy	ORG
islamic state	m.07v2k4	ORG
Jesse Ventura	m.0hd1l	PER
bank hapoalim	m.036yj8	ORG
charlie hebdo	m.06z90w	ORG
Massachusetts	m.05k7sb	GPE
One Direction	m.0fqqnpw	ORG
Mediterranean	m.07f7z7	LOC
Hitachi, Ltd.	m.019tk3	ORG
jewish agency	m.01k38p	ORG
Alí Jameneí	m.0224jr	PER
Michael Moore	m.0jw67	PER
Deng Xiaoping	m.028_0	PER
David Cameron	m.0266lb	PER
Medio Oriente	m.04wsz	LOC
Asia del Este	m.02qnk	LOC
Mercedes-Benz	m.052mx	ORG
us government	m.01bqks	ORG
Prensa Latina	m.03hj08z	ORG
iron mountain	m.02rdq1m	ORG
chicago bulls	m.0jm74	ORG
Oriente Medio	m.04wsz	LOC
BORIS Nemtsov	m.05fz6q	PER
radical party	m.0ndj1nk	ORG
Kgosi Mampuru	m.0gvr1cs	FAC
Lulz Security	m.0gvrvjk	ORG
piece of shit	m.09k0f	PER
mashregh news	m.0qs9ct0	ORG
África negra	m.06qtn	LOC
Dong Zhongshu	m.05nyrp	PER
Río Amarillo	m.0df3z	LOC
Boris Yeltsin	m.01krs	PER
south america	m.06n3y	LOC
Estados Unido	m.09c7w0	GPE
Feng Xiaogang	m.04xhrq	PER	NAM
Juan Pablo II	m.05yfx	PER
Ronald Reagan	m.06c0j	PER
Johannesburgo	m.0g284	GPE
Wang Jingwei	m.0x2w0	PER
sphere books	m.0b8ggv	ORG
Kgosi Mapuru	m.0gvr1cs	FAC
Tsanaga Mayo	m.05zz35l	GPE
Ku Klux Klan	m.048qr	ORG
bayit yehudi	m.04zxt7x	ORG
PAULINA PE?A	m.0k1_v1x	PER
Adolf Hitler	m.07_m9_	PER
Stephenville	m.0100ym	GPE
Barbara Bush	m.015nr6	PER
Río Jordán	m.0cvy5	LOC
Playa Girón	m.0j7nh2h	LOC
The Atlantic	m.0137v8	ORG
Isaac Herzog	m.0cf7z6	PER
Heilongjiang	m.017g08	GPE
Premio Nobel	m.059x1	ORG
moscow river	m.01tkzh	LOC
Bloemfontein	m.0c499	GPE
Pennsylvania	m.05tbn	GPE
Philadelphia	m.0dclg	GPE
Cristianismo	m.01lp8	ORG
Byron Moreno	m.06b7r4	PER
río Moscova	m.01tkzh	LOC
boston globe	m.07dk8	ORG
Mundo árabe	m.0150_4	LOC
Rafael Nadal	m.051q39	PER	NAM
Pearl Harbor	m.097gl	LOC
south africa	m.0hzlz	GPE
Raúl Castro	m.01gcjq	PER
Aqsa Mahmood	m.011pdv3r	PER
Swiss Police	m.02hnhx	ORG
George Soros	m.0gyk6w	PER
Alfred Nobel	m.0k6j	PER
Diane Sawyer	m.02dh86	PER
Levi Strauss	m.01yvw2	PER
Trevor Ariza	m.07g5gp	PER
Robert Reich	m.01xbj3	PER
north africa	m.05g2v	LOC
South Africa	m.0hzlz	GPE
Eric Rudolph	m.01jhw2	PER
Europa Press	m.0g57m4y	ORG
Causeway Bay	m.019cdg	LOC
west village	m.0bwc0b	LOC
Paulina Pe?a	m.0k1_v1x	PER
Río Moscova	m.01tkzh	LOC
Jon Huntsman	m.04p8tt	PER
sudamericano	m.06n3y	LOC
Anna Chapman	m.0ch3nsb	PER
Tsai Ing-wen	m.0bhd24	PER
Nueva Jersey	m.05fjf	GPE
Marcos Rubio	m.0dpr5f	PER
israel hayom	m.02wbf0m	ORG
Bill Clinton	m.0157m	PER
Guo Shengkun	m.0qscgfz	PER	NAM
Asia Central	m.01z5y	LOC
Mao Tze Tung	m.04xzm	PER
West Germany	m.082fr	GPE
Asia central	m.01z5y	LOC
Bardo museum	m.047prs0	FAC
western cape	m.01tjt2	ORG
Somalilandia	m.0dkly	GPE
Great Plains	m.0dkwn	LOC
central asia	m.01z5y	LOC
Asia del Sur	m.06nn1	LOC
Justin Welby	m.03nqpg8	PER
Chuck Blazer	m.0gj8y7p	PER
venechaburra	m.07ylj	GPE
north korean	m.05b7q	GPE
Republicanos	m.07wbk	ORG
vatican city	m.07ytt	GPE
Johannesburg	m.0g284	GPE
Hugo Chávez	m.0d1b_	PER
Enrique Pe?a	m.07zcdm	PER
Sadam Husein	m.079dy	PER
Gobernación	m.09zdpf	ORG
Josh Earnest	m.0l8ps43	PER
Los Ángeles	m.030qb3t	GPE
Sierra Leona	m.06s_2	GPE
suramericano	m.06n3y	LOC
Aurelio Nu?o	m.0swpftv	PER
texas senate	m.03w950g	ORG
Asia-Pacific	m.055yrc	LOC
armed forces	m.07xg1	ORG
Nancy Pelosi	m.012v1t	PER
Fidel Castro	m.09k0f	PER
Michael Dell	m.013q3z	PER
eastern bloc	m.0p366	LOC
moskva river	m.01tkzh	LOC
the atlantic	m.0137v8	ORG
DrudgeReport	m.01dgg6	ORG
Los Hamptons	m.011wsc	LOC
marine corps	m.01skqzw	ORG
John Boehner	m.039rwf	PER
Google Voice	m.02q0knk	ORG
Freddie Gray	NIL10000	PER
Oakley, Inc.	m.028tf_	ORG
saudi arabia	m.01z215	GPE
moscow metro	m.0hkhn	FAC
Shāng Tāng	m.08gx70	PER
Monte Paektu	m.018x45	LOC	NAM
Harry Browne	m.0qfsz	PER
West Village	m.0bwc0b	LOC
persian gulf	m.0661z	LOC
east african	m.01mqb6	LOC
Manuel Valls	m.047drb0	PER
right sector	m.0_ljvdc	ORG
J. P. Morgan	m.018tj4	PER
Emperador Wu	m.01xvwq	PER
O.J. Sipmson	m.016mbz	PER
Chris Patten	m.01cp71	PER
Warner Bros.	m.086k8	ORG
Buenos Aires	m.01ly5m	GPE
Hassan Aweys	m.0d_tlz	PER
Willy Toledo	m.03c8w80	PER
sierra leone	m.06s_2	GPE
Barack Obama	m.02mjmr	PER
The Guardian	m.0cnn5	ORG
Shijiazhuang	m.0259f4	GPE	NAM
soviet union	m.05vz3zq	GPE
fifth avenue	m.01y5qy	LOC
republicanos	m.07wbk	ORG
East Germany	m.03f2w	GPE
Duma Estatal	m.03yxy7	ORG
kenya police	m.0dw4p2	ORG
Marina Silva	m.047dbx9	PER
Lianyungang	m.03pkgv	GPE	NAM
republicana	m.07wbk	ORG
west africa	m.0hqjh	LOC
Jack Warner	m.074byn	PER
john mccain	m.0bymv	PER
Rebublicans	m.07wbk	ORG
Li Ka-Shing	m.01pfdg	PER
Eric Holder	m.0465sdr	PER
Tzipi Livni	m.08_4rx	PER
Jia Qinglin	m.01m54p	PER	NAM
Sudamérica	m.06n3y	LOC
Donna Karan	m.0132t8	PER
Ban Ki-moon	m.075jlq	PER
Ye Jianying	m.02v2s9	PER
Makhachkala	m.02dpch	GPE
soviet bloc	m.0p366	LOC
Shinzō Abe	m.07t7hy	PER
ground zero	m.0hpjf	FAC
darién gap	m.02833_	LOC
Tayikistán	m.07dvs	GPE
Saeb Erekat	m.02pqnx	PER
Raul Castro	m.01gcjq	PER
Republicans	m.07wbk	ORG
quuds force	m.0bd931	ORG
republicano	m.07wbk	ORG
Casa Blanca	m.081sq	ORG
Judy Clarke	m.0g5rcy7	PER
Indian Army	m.01ygr_	ORG
británicas	m.07ssc	GPE
Dylann Roof	NIL10002	PER
Zhongnanhai	m.01w_z3	LOC
sierra club	m.01k3zl	ORG
us congress	m.07t31	ORG
gombe state	m.04gbv7	GPE
Kim Jung Un	m.0fgw19	PER
Zhangjiajie	m.090960	GPE	NAM
syrian army	m.04n7jf6	ORG
Afganistán	m.0jdd	GPE
complutense	m.0mf1x	ORG
middle east	m.04wsz	LOC
Nueva Delhi	m.0dlv0	GPE
afghanistan	m.0jdd	GPE
Afgahnistan	m.0jdd	GPE
demócratas	m.0d075m	ORG
Pitt Street	m.03_nsd	LOC
Suazilandia	m.06v36	GPE
Amelia Roof	NIL10005	PER
VENEZOLANOS	m.07ylj	GPE
sudafricano	m.0hzlz	GPE
south sudan	m.05rznz	GPE
addis ababa	m.0dttf	GPE
Mitt Romney	m.0271_s	PER
Ali Jamenei	m.0224jr	PER
Nicaraguans	m.05c74	GPE
Miami Beach	m.0rnmy	LOC
Al-Shabbaab	m.027ggxz	ORG
east africa	m.01mqb6	LOC
Qinhuangdao	m.015vvs	GPE	NAM
Ciudad Sadr	m.01dxsk	GPE
Li Qingzhao	m.02hy0c	PER
al-Baghdadi	m.02843s6	GPE
Adís Abeba	m.0dttf	GPE
uk military	m.07sx7	ORG
Sun Yat-sen	m.0m56y	PER
Kim Jong-il	m.0143y5	PER	NAM
Cisjordania	m.082pc	LOC
Zhuge Liang	m.01nl3p	PER
Dina Eidman	m.0hh_q4t	PER
Lindsey Fry	NIL10006	PER
paddy power	m.04219f	ORG
third-party	m.01vb2m	ORG
BNP Paribas	m.02qhk4	ORG
Javad Zarif	m.0c1pjf	PER
Pop Madonna	m.01vs_v8	PER
Kim Jong-un	m.0fgw19	PER
Los Aliados	m.06v9sf	ORG
likud party	m.01dcs1	ORG
new england	m.029jpy	GPE
Larry Hogan	m.0_ylz5n	PER
irish times	m.012vh7	ORG
white house	m.081sq	FAC
twin towers	m.083_h	FAC
Uzbekistán	m.07t_x	GPE
wall street	m.09937	FAC
PRP-Parnás	m.0642d9w	ORG
Solidarnost	m.051zzmm	ORG
Kazajistán	m.047lj	GPE
north korea	m.05b7q	GPE
Palestinian	m.01k0p4	GPE
Wall Street	m.09937	FAC
Burger King	m.01601q	FAC
mitt romney	m.0271_s	PER
Pensilvania	m.05tbn	GPE
O.J Simpson	m.016mbz	PER
oval office	m.01hhz7	FAC
Sayyid Qutb	m.02v15j	PER
sudafricana	m.0hzlz	GPE
Minneapolis	m.0fpzwf	GPE
Jackie Chan	m.012d40	PER	NAM
free beacon	m.0j9pbdl	ORG
rough creek	m.04bxyzx	LOC
Chiautempan	m.02qdfgn	GPE
camerunesas	m.01nln	GPE
Reino Unido	m.07ssc	GPE
Puerto Rico	m.05r7t	GPE
Mesopotamia	m.0524v	LOC
Switzerland	m.06mzp	GPE
Huo Yuanjia	m.06_dm4	PER
us military	m.07xg1	ORG
venezolanos	m.07ylj	GPE
Bolchevique	m.01k8_	ORG
James Baker	m.01f6t5	PER
a. o. scott	m.052950	PER
Middle-East	m.04wsz	LOC
Borno State	m.06xjkq	GPE
warner bros	m.086k8	ORG
Secretariat	m.015kq0	ORG
puerto rico	m.05r7t	GPE
darrien gap	m.02833_	LOC
Westminster	m.09bkv	GPE
los angeles	m.030qb3t	GPE
Azerbaiyán	m.0jhd	GPE
Vanity Fair	m.01q2nh	ORG
whole foods	m.02xf2l	FAC
Venezolanos	m.07ylj	GPE
John Oyegun	m.09rwd0n	PER
Cosa Nostra	m.05489	ORG
Kirguistán	m.0jt3tjf	GPE
Park Street	NIL10008	FAC
Guantánamo	m.01qh2d	GPE
Vladivostok	m.0fd_x	GPE
Sergey Brin	m.0gjq6	PER
Sudetenland	m.0bs57	LOC
neoyorquino	m.02_286	GPE
Kevin Davis	NIL10001	PER
burger king	m.01601q	FAC
RIU Hotels	m.05dm4t	ORG
Somaliland	m.0dkly	GPE
Nueva York	m.02_286	GPE
Hay futuro	m.02vmvyr	ORG
Michoacán	m.01btry	GPE
Liu Shaoqi	m.0m8qm	PER
Hezzbollah	m.03m7d	ORG
demócrata	m.0d075m	ORG
ExxonMobil	m.02s6x	ORG
tana river	m.098gc4	GPE
americanas	m.09c7w0	GPE
Ingushetia	m.03cwg6	GPE
McDonald's	m.07gyp7	ORG
Kommersant	m.04bqps	ORG
Jerusalén	m.0430_	GPE
Qi Jiguang	m.05g98_	PER
Copenhagen	m.01lfy	GPE
Buckingham	m.01dcq4	GPE
Washington	m.060d2	ORG
Al-Shababb	m.027ggxz	ORG
Indonesian	m.03ryn	GPE
Kurdistán	m.0kwd9	GPE
Fatherland	m.06f8sh	ORG
Mao Zedong	m.04xzm	PER
al jazeara	m.0pdbv90	ORG
Madagascar	m.04sj3	GPE	NAM
Georgetown	m.01c60h	LOC
Gary Locke	m.05mzh3h	PER
Sudamerica	m.06n3y	LOC
east timor	m.02lx0	GPE
Daguestán	m.0387gc	GPE
Jacob Zuma	m.0466k4	PER
Bangladesh	m.0162b	GPE
Pentágono	m.07y0n	ORG
Charleston	m.0gkgp	GPE
La Alameda	m.01dmcq	FAC
Al Jazeera	m.027glbp	ORG
iraqi army	m.03slm	ORG
Boko Haram	m.06zrg5s	ORG
Inglaterra	m.02jx1	GPE
west texas	m.02wzq6	LOC
Eslovaquia	m.06npd	GPE	NAM
Midlothian	m.0100vw	GPE
quds force	m.0bd931	ORG
soviético	m.05vz3zq	GPE
Al-shebaab	m.027ggxz	ORG
red square	m.0hm_7	FAC
Afganistan	m.0jdd	GPE
Trey Gowdy	m.0c3x3rz	PER
boko haram	m.06zrg5s	ORG
jorge bush	m.09b6zr	PER
us marines	m.01skqzw	ORG
UC Browser	m.047nwms	ORG
venezolana	m.07ylj	GPE
Paige Roof	NIL10004	PER
peshmergas	m.03m_n0	ORG
Kuomintang	m.049tb	ORG
Mogadiscio	m.0gclb	GPE
Ben Rhodes	m.04j4_qc	PER
Manchester	m.052bw	GPE
británico	m.07ssc	GPE
Gengis Kan	m.0bq53	PER
new jersey	m.05fjf	GPE
fort riley	m.0150dm	FAC
Zhang Jike	m.0cnyz7x	PER	NAM
nazi party	m.05g9h	ORG
Zayn Malik	m.0h3cltm	PER
mit police	m.0t52dbz	ORG
Puntlandia	m.01hywq	GPE
Li Jianguo	m.04cyv23	PER	NAM
Copenhague	m.01lfy	GPE
Hay Futuro	m.02vmvyr	ORG
buger king	m.01601q	FAC
Yair Lapid	m.07dt0z	PER
Alan Gross	m.0gh8r7s	PER
al Hasakah	m.050tnk	GPE
Monte Song	m.04dv9b	LOC
Santa Cruz	m.02k_hk	GPE
boko harum	m.06zrg5s	ORG
nigerianas	m.05cgv	GPE
Kala Balge	m.080cq2z	GPE
B. Obummer	m.02mjmr	PER
Filadelfia	m.0dclg	GPE
Dylan Roof	NIL10002	PER
abu ghraib	m.02y6f3	FAC
Sudáfrica	m.0hzlz	GPE
británica	m.07ssc	GPE
BRASILENOS	m.015fr	GPE
Venezuelan	m.07ylj	GPE
Parliament	m.03mkh	ORG
Antártida	m.0jfx	LOC
israelíes	m.03spz	GPE
Sinn Féin	m.06_72	ORG
Dorchester	m.02s838	LOC
venezolano	m.07ylj	GPE
Mar Caribe	m.02613	LOC
Winchester	m.058pnp	ORG
Xi Jinping	m.06ff60	PER
boko harem	m.06zrg5s	ORG
Chris Kyle	m.0hzrl7z	PER
Rossiya 24	m.04gpgmn	ORG
California	m.01n7q	GPE
sinn féin	m.06_72	ORG
Fort Riley	m.0150dm	FAC
Plaza Roja	m.0hm_7	FAC
Pussy Riot	m.0j3ds8q	ORG
John Kerry	m.0d3qd0	PER
Chernóbil	m.01tsk	GPE
al shabaab	m.027ggxz	ORG
Papá Noel	m.027g6wt	PER
al jazeera	m.027glbp	ORG
inglaterra	m.07ssc	GPE
Ross Perot	m.0bxhx	PER
Wangfujing	m.03fxs7	LOC
Costa Rica	m.01p8s	GPE
Australian	m.0chghy	GPE
Argentinas	m.0jgd	GPE
Parlamento	m.09ryyj	ORG
Al-Shabaab	m.027ggxz	ORG
Vermonters	m.07_f2	GPE
Santa Sede	m.03h1x	ORG
WASHINGTON	m.0rh6k	GPE
Li Xiaoxia	m.02rjl53	PER	NAM
gaza strip	m.0357_	LOC
Democratic	m.0d075m	ORG
Whitewater	m.04njqx	ORG
navy seals	m.09j2x	ORG
DreamWorks	m.01gb54	ORG
Al Bagdadi	m.0h7q0rq	PER
Greenpeace	m.036qv	ORG
Wu Bangguo	m.01m1g5	PER	NAM
pussy riot	m.0j3ds8q	ORG
Li Keqiang	m.052vrq	PER
Huntsville	m.010bf6	GPE
Zhou Enlai	m.0dbk8	PER
Wen Jiabao	m.01f6g3	PER	NAM
gulf coast	m.034rx	LOC
ucranianos	m.07t21	GPE
republican	m.07wbk	ORG
Yobe State	m.06pqtg	GPE
Dharamsala	m.0j65lnw	LOC
la iglesia	m.02vxy_	ORG
Bangladés	m.0162b	GPE
John Lewis	m.02555z	PER
Calle Pitt	m.03_nsd	LOC
argentinos	m.0jgd	GPE
Stormfront	m.03bmkz	ORG
Núremberg	m.05bkf	GPE
Yugoslavia	m.087vz	GPE
Eurotúnel	m.01qnw	FAC
Luxemburgo	m.04g61	GPE
Liverpool	m.04lh6	GPE
Hiroshima	m.0g3cw	GPE
Isralíes	m.03spz	GPE
nigeriana	m.05cgv	GPE
nigeriano	m.05cgv	GPE
Barcelona	m.01f62	GPE
Las Vegas	m.0cv3w	GPE
Río Juba	m.023v5f	LOC
boliviano	m.0165v	GPE
Bald Knob	m.0qxlh	GPE
cape town	m.01yj2	GPE
Uncle Sam	m.09c7w0	GPE
GreenTech	m.0sghmt8	ORG
Shanghái	m.06wjf	GPE
mexicanos	m.0b90_r	GPE
malienses	m.04v09	GPE
Watertown	m.0t_8w	GPE
Wellesley	m.017v71	ORG
brasile?o	m.015fr	GPE
Petrobras	m.05v1x6	ORG
Woolwhich	m.0_gzsyk	LOC
al shabab	m.027ggxz	ORG
Pakistán	m.05sb1	GPE
Yazidismo	m.01h7l_	ORG
Chongqing	m.017236	GPE
Coca-Cola	m.01yvs	ORG
Jerusalem	m.0430_	GPE
VICE NEWS	m.011q2zfc	ORG
bald knob	m.0qxlh	GPE
ITAR-TASS	m.0283lh	ORG
Lancaster	m.0__w_	GPE
australia	m.0chghy	GPE
Nicaragua	m.05c74	GPE
Amazonian	m.0cx4p	LOC
the hague	m.07g0_	GPE
Tal Tamer	m.0bhq2m	GPE
Ala Oeste	m.0373td	FAC
Yesh Atid	m.02vmvyr	ORG
uncle sam	m.09c7w0	GPE
brasile?a	m.015fr	GPE
pakastani	m.05sb1	GPE
Venezuela	m.07ylj	GPE
Lithuania	m.04gzd	GPE
mar Negro	m.015h7	LOC
Hu Jintao	m.013my_	PER	NAM
fort knox	m.0k4yq	FAC
Mpeketoni	m.026ls76	GPE
Dagestani	m.0387gc	GPE
Melbourne	m.01_gm67	GPE	NAM
Brookings	m.01x7wr	ORG
laborista	m.0207yf	ORG
VENEZUELA	m.07ylj	GPE
Roodeport	m.04ys30	LOC
Américas	m.07c5l	LOC
Australia	m.0chghy	GPE
west bank	m.082pc	LOC
Estocolmo	m.06mxs	GPE
Chechenya	m.01tr1	GPE
ibadan sw	m.09gflrq	GPE
Hezbollah	m.03m7d	ORG
Yaroslavl	m.0196_0	GPE
sri lanka	m.06m_5	GPE
Tailandia	m.07f1x	GPE
Datafolha	m.0p3qbn7	ORG
americano	m.09c7w0	GPE
Hollywood	m.0f2wj	LOC
nigerinas	m.05cgv	GPE
Nuremburg	m.05bkf	GPE
iraquíes	m.0d05q4	GPE
Benn Roof	NIL10003	PER
McClatchy	m.03y7ml	ORG
Apple Inc	m.0k8z	ORG	NAM
Occidente	m.020wr2	LOC
Odintsovo	m.0b5c6z	GPE
Jen Psaki	m.09v900n	PER
Asheville	m.0ydpd	GPE
argentino	m.0jgd	GPE
Air China	m.01rjgp	ORG
espa?olas	m.06mkj	GPE
argentina	m.0jgd	GPE
Liu Xiang	m.03kt92	PER
La Habana	m.0d6hn	GPE
Ethiopian	m.019pcs	GPE
Taya Kyle	m.0n9sd9l	PER
Nashville	m.05jbn	GPE
Chechenia	m.01tr1	GPE
Mar Negro	m.015h7	LOC	NAM
Conaculta	m.02qkszp	ORG
Bolshevik	m.01k8_	ORG
Anonymous	m.03nr1np	ORG
Chechnyan	m.01tr1	GPE
Jordanian	m.03__y	GPE
Red Cross	m.0c_bfw	ORG
Sudafrica	m.0hzlz	GPE
Pakistani	m.05sb1	GPE
Maiduguri	m.06plf6	GPE
Pearl Jam	m.0d193h	ORG
el Frente	m.0j44g62	ORG
Islamabad	m.0dhd5	GPE	NAM
VANCOUVER	m.080h2	GPE
Edimburgo	m.02m77	GPE
Tea Party	m.09v571r	ORG
Filipinas	m.05v8c	GPE
Nuremberg	m.05bkf	GPE
brasilero	m.015fr	GPE
Rand Paul	m.05pdb7q	PER
Louisiana	m.04ly1	GPE
Hong Kong	m.03h64	GPE
Chappaqua	m.0yb_v	GPE
Babilonia	m.0cn3b	GPE
brasillia	m.01hy_	GPE
WikiLeaks	m.027m_21	ORG
Democrats	m.0d075m	ORG
Musulmán	m.04y29	ORG
Mogadishu	m.0gclb	GPE
ALJEZEERA	m.027glbp	ORG
BBC WORLD	m.09cw9	ORG
ANONYMOUS	m.03nr1np	ORG
Navy SEAL	m.09j2x	ORG
Los Pinos	m.05784f	FAC
Grupo 5+1	m.0jwv6z7	ORG
Cromagnon	m.04vn41	FAC
Ukrainian	m.07t21	GPE
Sheffield	m.0m75g	GPE
Finlandia	m.02vzc	GPE
Palestine	m.01k0p4	GPE
Dartmouth	m.0tyms	GPE
Palestina	m.0h44w	GPE
sudafrica	m.0hzlz	GPE
Abu Dhabi	m.0gxj	GPE	NAM
Karl Marx	m.048cl	PER
Argentina	m.0jgd	GPE
Nassawara	m.06xjq0	GPE
Malinalco	m.01w2vp	GPE
Stockholm	m.06mxs	GPE
Har Homá	m.070bzm	LOC
Utah Jazz	m.0jmhr	ORG
Dinamarca	m.0k6nt	GPE
dem party	m.0d075m	ORG
Ingusetia	m.03cwg6	GPE
abu dhabi	m.027kytm	GPE
Chinatown	m.01t41x	FAC
Marruecos	m.04wgh	GPE	NAM
Chernobyl	m.01tsk	GPE
Palestino	m.01k0p4	GPE
Joe Biden	m.012gx2	PER
The Times	m.09rkd	ORG
Changchun	m.01l3md	GPE	NAM
Mexicanos	m.0b90_r	GPE
Singapore	m.06t2t	GPE
pizza hut	m.09cfq	FAC
Hershey's	m.0lq_7	ORG
al-shabab	m.027ggxz	ORG
Veraderro	m.01cxyk	GPE
caribeño	m.0261m	LOC
us forces	m.07xg1	ORG
Americana	m.09c7w0	GPE
us senate	m.07t58	ORG
sinn fein	m.06_72	ORG
Indonesia	m.03ryn	GPE
Caribbean	m.0261m	LOC
palestino	m.047876	GPE
palestina	m.01k0p4	GPE
petrobras	m.05v1x6	ORG
Pizza Hut	m.09cfq	FAC
Macmillan	m.041f8t	ORG
Las Lomas	m.0y7wt3r	GPE
ucraniano	m.07t21	GPE
Eslovenia	m.06t8v	GPE	NAM
Amércias	m.07c5l	LOC
Katmandú	m.04cx5	GPE
Tampa Bay	m.02z4zg	LOC
Minnesota	m.04ykg	GPE
tea party	m.09v571r	ORG
Wisconsin	m.0824r	GPE
Bloomberg	m.0vpsrmz	ORG
pearl jam	m.0d193h	ORG
utah jazz	m.0jmhr	ORG
Tian Shan	m.01ff84	LOC
Glen Rose	m.0108ym	GPE
Xu Shiyou	m.03whh8y	PER	NAM
Euphrates	m.02s22	LOC
podemitas	m.0_qfn6p	ORG
Colombian	m.01ls2	GPE
las vegas	m.0cv3w	GPE
Wikileaks	m.027m_21	ORG
Fort Knox	m.0k4yq	FAC
Starbucks	m.018c_r	ORG
la Kristi	m.05k5_1	PER
Microsoft	m.04sv4	ORG
Americano	m.09c7w0	GPE
Americans	m.09c7w0	GPE
San Pablo	m.022pfm	GPE
Park Lane	m.01bd3q	FAC
Vancouver	m.080h2	GPE
u.s. navy	m.07wg3	ORG
Isabel II	m.0d1_f	PER
Pyongyang	m.0cw5k	GPE
Baltimore	m.094jv	GPE
san-pablo	m.022pfm	GPE
Sri Lanka	m.06m_5	GPE
nbc news	m.016bvz	ORG
Abu Dabi	m.027kytm	GPE
Hacienda	m.026p_2j	ORG
Bacardí	m.01k6v	ORG
Hezbolá	m.03m7d	ORG
Russians	m.06bnz	GPE
Pionyang	m.0cw5k	GPE
Justicia	m.0j7k_yv	GPE
Yinchuan	m.02cwbw	GPE	NAM
Tunisian	m.07fj_	GPE
Japanese	m.03_3d	GPE
al-Qaida	m.0v74	ORG
Armenian	m.0jgx	GPE
Tim Cook	m.05r65m	PER	NAM
Dortmund	m.0135k2	GPE	NAM
Mongolia	m.04w8f	GPE
Damascus	m.02gjp	GPE
NBC News	m.016bvz	ORG
HuffPost	m.0hmrpgb	ORG
Westover	m.010y3w	GPE
Moldavia	m.04w4s	GPE
Liu Bang	m.01xscr	PER
Kingston	m.09b8m	GPE
Sky News	m.01fp7c	ORG
Mercosur	m.01pdw8	ORG
European	m.02j9z	LOC
Santiago	m.0dlqv	GPE
Camerún	m.01nln	GPE
Ferguson	m.011q36c2	GPE
Hospital	m.074kdj	FAC
Djibouti	m.027jk	GPE
Al-Kebab	m.027ggxz	ORG
Lei Feng	m.01rf1d	PER
Caucasus	m.09shn	LOC
AL qAEDA	m.0v74	ORG
europeas	m.02j9z	LOC
Lebanese	m.04hqz	GPE
Budapest	m.095w_	GPE	NAM
Jeb Bush	m.019x9z	PER
Paraguay	m.05v10	GPE
Chrysler	m.01_bp	ORG
Cambodia	m.01xbgx	GPE
Shenzhen	m.0lbmv	GPE
Mar Rojo	m.06jfd	LOC
al-Qaeda	m.0v74	ORG
Liaoning	m.014ck4	GPE
Pentagon	m.07y0n	ORG
Gobierno	m.01bqks	ORG
Zhuangzi	m.0164zy	PER
dr congo	m.088xp	GPE
Cornwall	m.01q1	GPE
Bélgica	m.0154j	GPE
Columbia	m.01ls2	GPE
Potiskum	m.09g97jg	GPE
Facebook	m.0hmyfsv	ORG
democrat	m.0d075m	ORG
libanesa	m.04hqz	GPE
Colombia	m.01ls2	GPE
Portugal	m.05r4w	GPE
francesa	m.0f8l9c	GPE
PRETORIA	m.067z4	GPE
Interpol	m.03zzx	ORG
RTE News	m.042w8t	ORG
Tianjín	m.0df4y	GPE
Turquía	m.01znc_	GPE
De Beers	m.0f21v	ORG
Singapur	m.06t2t	GPE
Westgate	m.0xnxm0n	FAC
Teherán	m.0ftlx	GPE
Varadero	m.01cxyk	GPE
nagasaki	m.05gqf	GPE
Colorado	m.01n4w	GPE
Winnipeg	m.0pmq2	GPE
Crawford	m.01068n	GPE
Sinkiang	m.0jbn5	GPE
Al Qaida	m.0v74	ORG
MERCOSUR	m.01pdw8	ORG
Al Qaeda	m.0v74	ORG
al-Nusra	m.0j44g62	ORG
Hamptons	m.011wsc	LOC
Nasarawa	m.06xjq0	GPE
Tlaxcala	m.01cccz	GPE
Maldivas	m.04ty8	GPE
Himalaya	m.09glw	LOC
ABC News	m.01v3sw	ORG
al-Raqqa	m.03hz03	GPE
Amazonia	m.0cx4p	LOC
Mexicano	m.0b90_r	GPE
Boylston	m.027f7bt	LOC
Anáhuac	m.02746k8	FAC
Vólogda	m.02cn0p	GPE
Arkansas	m.0vbk	GPE
Islandia	m.03rj0	GPE
El Cairo	m.01w2v	GPE
Luisiana	m.04ly1	GPE
Atlantic	m.0137v8	ORG
Kentucky	m.0498y	GPE
CONCACAF	m.01r3zn	ORG
Bagdhdad	m.01fqm	GPE
Kismaayo	m.04gh99	GPE
Chechnya	m.01tr1	GPE
Iranians	m.03shp	GPE
Istanbul	m.09949m	GPE
irakíes	m.0d05q4	GPE
American	m.09c7w0	GPE
Al Karak	m.01sr16	GPE
Talibán	m.07jqh	ORG
Emirates	m.011_65	ORG
chechena	m.01tr1	GPE
Bahréin	m.0161c	GPE
Illinois	m.03v0t	GPE
Waterloo	m.084kf	GPE
Banghazi	m.01czt9	GPE
teaparty	m.09v571r	ORG
Wal-Mart	m.0841v	ORG
checheno	m.01tr1	GPE
Lausanne	m.04qdj	GPE
Baathist	m.0hncp2r	ORG
iraníes	m.03shp	GPE
Virginia	m.07z1m	GPE
Ramallah	m.0c11l	GPE
CBS News	m.01_8w2	ORG
Somalian	m.06tgw	GPE
Fallujah	m.02czjf	GPE
Sikorsky	m.01ncxn	ORG
chechén	m.01tr1	GPE
BBCWORLD	m.09cw9	ORG
Wan Chai	m.015n05	GPE
Ethiopia	m.019pcs	GPE
ihs inc.	m.04jb8dq	ORG
Confucio	m.01rll	PER
Yugoslav	m.087vz	GPE
al queda	m.0v74	ORG
tel aviv	m.07qzv	GPE
Heathrow	m.0n9z1	GPE
Pinellas	m.0jxgx	GPE
BENGHAZI	m.01czt9	GPE
Pakistan	m.05sb1	GPE
Guan Yin	m.04c0f	PER
Birmania	m.04xn_	GPE
Franklin	m.0_xdd	GPE
Florence	m.0rb16	GPE
Estambul	m.09949m	GPE
Etiopía	m.019pcs	GPE
Canadian	m.0d060g	GPE
Red Bank	m.0_mjb	GPE
FC Basel	m.021mkg	ORG
aso rock	m.07h407	FAC
América	m.07c5l	LOC
Cáucaso	m.09shn	LOC
Guerrero	m.01bttt	GPE
Saladino	m.06pz2	PER
Maryland	m.04rrd	GPE
Thomsons	m.08nm45	ORG
SKY NEWS	m.01fp7c	ORG
Yangtsé	m.01y4t	LOC
Xin Qiji	m.02ybgz	PER
Barclays	m.05t8c5	ORG
israelí	m.03spz	GPE
Herzliya	m.01tl2q	GPE
Abu Bakr	m.0h7q0rq	PER
La Plata	m.023b97	GPE
fox news	m.02z_b	ORG
Alemania	m.0345h	GPE
Treuhand	m.04vh2h	ORG
Interfax	m.0cv92n	ORG
Treasury	m.0f1r9	ORG
Yangzhou	m.03tgwz	GPE
Iraníes	m.03shp	GPE
BYD Auto	m.053dyg	ORG
new york	m.02_286	GPE
Kiribati	m.047t_	GPE
Shandong	m.0qb0j	GPE
New York	m.02_286	GPE
Damaturu	m.08jlmc	GPE
Nasiriya	m.01chkp	GPE
abc news	m.01v3sw	ORG
Ted Cruz	m.07j6ty	PER
Al-Qaeda	m.0v74	ORG
Lituania	m.04gzd	GPE
Congreso	m.07t31	ORG
Lin Biao	m.01rf6f	PER
Tanzania	m.07dzf	GPE
mexicana	m.0b90_r	GPE
mexicano	m.0b90_r	GPE
otanista	m.059dn	ORG
Pretoria	m.067z4	GPE
al shaba	m.027ggxz	ORG
cbs news	m.01_8w2	ORG
Chechens	m.01tr1	GPE
Tel Aviv	m.07qzv	GPE
Bruselas	m.0177z	GPE
TLAXCALA	m.01cccz	GPE
Victoria	m.0chgr2	GPE
al-Karak	m.01sr16	GPE
Basmanni	m.02qlykj	GPE
congress	m.07t31	ORG
al qaeda	m.0v74	ORG
Concacaf	m.01r3zn	ORG
al-Nursa	m.0j44g62	ORG
AL-Qaeda	m.0v74	ORG
Sina.com	m.02ck4_	ORG
al qaida	m.0v74	ORG
Vaticano	m.07ytt	GPE
Jordania	m.03__y	GPE
Úlster	m.07w9n	GPE
Sederot	m.02czws	GPE
alemana	m.0345h	GPE
Sídney	m.06y57	GPE
Arizona	m.0vmt	GPE
ALQAEDA	m.0v74	ORG
Vicenza	m.0prxp	LOC
Múnich	m.02h6_6p	GPE
Ganzhou	m.03rn2n	GPE	NAM
Belfast	m.01l63	GPE
Canadá	m.0d060g	GPE
Clinton	m.0157m	PER
Vilnius	m.07_kq	GPE
Academi	m.02qwr8	ORG
Madonna	m.01vs_v8	PER
Chicago	m.01_d4	GPE
Río Wu	m.05p513z	LOC
Kismayo	m.04gh99	GPE
Tribeca	m.01_45p	LOC
Alabama	m.0gyh	GPE
Liu Xiu	m.01yd4t	PER
Caracas	m.0fcyj	GPE
Ugandan	m.07tp2	GPE
Central	m.01dfnb	LOC
Bayelsa	m.06xjhs	GPE
Bahamas	m.0160w	LOC
Ireland	m.03rt9	GPE
Nankín	m.05gqy	GPE
Jiading	m.027q_7	GPE
Georgia	m.0d0kn	GPE
Qu Yuan	m.02xgl8	PER
Marines	m.01skqzw	ORG
Polonia	m.05qhw	GPE
Cantón	m.0393g	GPE
Soviets	m.05vz3zq	GPE
Donbass	m.0372_h	GPE
Svoboda	m.03c8q_g	ORG
Limpopo	m.01_zrk	GPE
Guangxi	m.01920m	GPE
Austria	m.0h7x	GPE
Knéset	m.0jxlq	ORG
alemán	m.0345h	GPE
Ginebra	m.03902	GPE
NOTIMEX	m.03h4jq2	ORG
Russian	m.06bnz	GPE
Uruguay	m.07twz	GPE
TUNISIA	m.07fj_	GPE
CENTCOM	m.01xsrd	ORG
Chechen	m.01tr1	GPE
Indiana	m.03v1s	GPE
Panamá	m.0fr_b	GPE
Reuters	m.0ps53	ORG
MidEast	m.04wsz	LOC
ARPANET	m.01lk6z	ORG
Francia	m.0f8l9c	GPE
somalia	m.06tgw	GPE
Katsina	m.06xjmt	GPE
English	m.02jx1	GPE
Ecuador	m.02k1b	GPE
AMERICA	m.09c7w0	GPE
Ostende	m.0145g9	GPE
Orlando	m.0jm4b	ORG
Ucrania	m.07t21	GPE
Lebanon	m.04hqz	GPE
Hershey	m.0lq_7	ORG
Pacific	m.05rgl	LOC
Taipéi	m.0ftkx	GPE
Sinopec	m.04sy2w	ORG	NAM
Irlanda	m.012wgb	LOC
Samarra	m.01clrh	GPE
Wyoming	m.0846v	GPE
Baghdad	m.01fqm	GPE
Bolivia	m.0165v	GPE
Verizon	m.07_dn	ORG
Emirati	m.0j1z8	GPE
África	m.0dg3n1	LOC
Italian	m.03rjj	GPE
Beckley	m.010yjl	GPE
Eritrea	m.02khs	GPE
Jiangsu	m.0166c7	GPE
yanquis	m.09c7w0	GPE
Liberia	m.04hzj	GPE
Nairobi	m.05d49	GPE
Benadir	m.01995g	GPE
Zúrich	m.08966	GPE
Haaretz	m.0h8mw	ORG
Sima Yi	m.020dgn	PER
Chilena	m.01p1v	GPE
Harvard	m.03ksy	ORG
israels	m.03spz	GPE
Burmese	m.04xn_	GPE
Chitwan	m.08ckqr	GPE
chilito	m.01p1v	GPE
España	m.06mkj	GPE
Yazidis	m.01h7l_	ORG
Vatican	m.07ytt	GPE
Belgian	m.0154j	GPE
Líbano	m.04hqz	GPE
Somalia	m.06tgw	GPE
BERNAMA	m.04b1xz	ORG
Vietnam	m.01crd5	GPE
Camboya	m.01xbgx	GPE
Toshiba	m.0g7xx	ORG
Kunming	m.01c06d	GPE
Mombasa	m.01cfd3	GPE
Turismo	m.08bprc	ORG
Burundi	m.0169t	GPE
Kurdish	m.0329by	LOC
Yarmouk	m.02vwdmx	LOC
Chengdu	m.016v46	GPE
Berlín	m.0156q	GPE
Ukraind	m.07t21	GPE
Argelia	m.0h3y	GPE
potemos	m.0_qfn6p	ORG
Nigeria	m.05cgv	GPE
Ibadán	m.01zsrb	GPE
Guiyang	m.01zxg8	GPE	NAM
Escocia	m.06q1r	GPE
mexican	m.0b90_r	GPE
Anambra	m.03nnkb	GPE
Garissa	m.02696gl	GPE
Bostón	m.01cx_	GPE
SKYNEWS	m.01fp7c	ORG
Almatý	m.0151s1	GPE	NAM
TANoids	m.0276bn	ORG
Podemos	m.0_qfn6p	ORG
DynCorp	m.01p3tj	ORG
Houston	m.03l2n	GPE
Belgium	m.0154j	GPE
NAIROBI	m.05d49	GPE
Hebrón	m.09lvk	GPE
Londres	m.04jpl	GPE
Malasia	m.09pmkv	GPE
Mari-El	m.02dvm8	GPE
Serbian	m.077qn	GPE
iranian	m.03shp	GPE
Florida	m.02xry	GPE
African	m.0dg3n1	LOC
Eurasia	m.02qkt	LOC
Palmira	m.059j7d	GPE
Budismo	m.092bf5	ORG
Everest	m.0blbd	LOC
Donetsk	m.02qbpd	GPE
Iglesia	m.02vxy_	ORG
Palmyra	m.059j7d	GPE
Vermont	m.07_f2	GPE
us army	m.07wh1	ORG
TeleSur	m.05br87	ORG
Walmart	m.0841v	ORG
EE. UU.	m.09c7w0	GPE
Oregón	m.05kj_	GPE
Channel	m.02j7k	LOC
Shantou	m.01nm6k	GPE
Beijing	m.01914	GPE
Twitter	m.0289n8t	ORG
Germany	m.0345h	GPE
Hu Shih	m.0lz2n	PER
Lausana	m.04qdj	GPE
TriBeCa	m.01_45p	LOC
Shaanxi	m.014clr	GPE	NAM
shabaab	m.027ggxz	ORG
Seattle	m.0d9jr	GPE
Cámara	m.0b3wk	ORG
espa?ol	m.06mkj	GPE
America	m.09c7w0	GPE
ukraine	m.07t21	GPE
Chinese	m.0d05w3	GPE
Afrikah	m.07fj_	GPE
Bosnian	m.0166b	GPE
Buratai	NIL10002	PER
La Haya	m.07g0_	GPE
Denmark	m.0k6nt	GPE
Estonia	m.02kmm	GPE
México	m.0b90_r	GPE
Israeli	m.03spz	GPE
Bengasi	m.01czt9	GPE
Toscana	m.07kg3	GPE
LONDRES	m.04jpl	GPE
Moísmo	m.058_6	ORG
Quartet	m.06f_09	ORG
Zhenbao	m.04vj48	LOC
Urumchi	m.01c8t6	GPE
Chen Yi	m.01sxz9	PER
Haditha	m.07892s	GPE
La Meca	m.058wp	GPE
Olympic	m.05nd_	ORG
Maghreb	m.01yqpw	LOC
Moldova	m.04w4s	GPE
Abilene	m.013m_x	GPE
Siberia	m.07bfd	LOC
Kremlin	m.02ps5qq	GPE
Damasco	m.02gjp	GPE
cabinet	m.07x_h	ORG
hwy 287	m.028k8j	FAC
KGB-FSB	m.04b6p	ORG
Legismo	m.01gz6c	ORG
iraquí	m.0d05q4	GPE
iranies	m.03shp	GPE
Mandera	m.02696l0	GPE
Sandton	m.01t7hg	LOC
Adamawa	m.03nnjk	GPE
Toronto	m.0h7h6	GPE	NAM
houthis	m.047vsxx	ORG
Al Asad	m.01_vwx	PER
Armenia	m.0jgx	GPE
Itu Aba	m.057g9l	LOC	NAM
Hatnuá	m.0nhj5ll	ORG
Poynter	m.03mj0sh	ORG
Sichuan	m.0hbbx	GPE
Colombo	m.0fn7r	GPE
Bahrain	m.0161c	GPE
Turkish	m.01znc_	GPE
YouTube	m.09jcvs	ORG
Kampala	m.0fngy	GPE
Al Gore	m.0d05fv	PER
Jamaica	m.03_r3	GPE
England	m.07ssc	GPE
twitter	m.0289n8t	ORG
Gauteng	m.01t05t	GPE
Montana	m.050l8	GPE
Barāwe	m.09rq90	GPE
lulzsec	m.0gvrvjk	ORG
Kaifeng	m.01kdyf	GPE
Maryino	m.05p0kgt	GPE
Noruega	m.05b4w	GPE
Detroit	m.02dtg	GPE
Knesset	m.0jxlq	ORG
Britain	m.07ssc	GPE
algeria	m.0h3y	GPE
Roswell	m.06jdl	GPE
Spanish	m.06mkj	GPE
Brunéi	m.0167v	GPE
Levante	m.04l_r	LOC
Hamás	m.03m6j	ORG
ISAREL	m.03spz	GPE
Egipto	m.02k54	GPE
Caribe	m.0261m	LOC
Libyan	m.04gqr	GPE
Chipre	m.01ppq	GPE
sirias	m.06vbd	GPE
MEXICO	m.0b90_r	GPE
Browne	m.0qfsz	PER
marine	m.01skqzw	ORG
Tikrit	m.01cdk1	GPE
Moskvy	m.04swd	GPE
Jordan	m.03__y	GPE
U.S.A.	m.09c7w0	GPE
Serbia	m.077qn	GPE
Níger	m.05cc1	GPE
Unesco	m.05yg8kx	ORG	NAM
Lesoto	m.04hvw	GPE
Dylann	NIL10002	PER
CUBANO	m.0d04z6	GPE
Atocha	m.01rblq	FAC
Uganda	m.07tp2	GPE
Hawái	m.03gh4	GPE
París	m.05qtj	GPE
merica	m.09c7w0	GPE
Thames	m.0d2kt	LOC
AMISOM	m.0g_sw6	ORG
Houthi	m.047vsxx	ORG
Armagh	m.02dtqs	GPE
Huawei	m.01qkl1	ORG	NAM
Havana	m.0d6hn	GPE
Soviet	m.05vz3zq	GPE
tejano	m.07b_l	GPE
Levant	m.04l_r	LOC
Sydney	m.06y57	GPE
Lubeca	m.04hhb	GPE
Ulster	m.07w9n	GPE
Misuri	m.04ych	GPE
Syrian	m.06vbd	GPE
Bagdad	m.01fqm	GPE
Poland	m.05qhw	GPE
Athens	m.0n2z	GPE
Amelia	NIL10005	PER
balkan	m.01jjk	LOC
Belén	m.01cy_	GPE
Unicef	m.0fxc0	ORG
africa	m.0dg3n1	LOC
Italia	m.03rjj	GPE
Mahoma	m.04s9n	PER
Natanz	m.04b9pf	GPE
Hanói	m.0fnff	GPE	NAM
Tierra	m.02j71	LOC
Harbin	m.0123gq	GPE
UNICEF	m.0fxc0	ORG
Faluya	m.02czjf	GPE
alshbb	m.027ggxz	ORG
Geneva	m.03902	GPE
Malaya	m.01s8rk	GPE
Kosovo	m.04fh3	GPE
German	m.0345h	GPE
Forbes	m.01r2lw	ORG
Munich	m.02h6_6p	GPE
Romney	m.0271_s	PER
Dallas	m.0f2rq	GPE
France	m.0f8l9c	GPE
sirios	m.06vbd	GPE
Abadam	m.0804_ts	GPE
Mariel	m.02gzms	GPE
Fenton	m.0w_rw	GPE
asiria	m.06vbd	GPE
Ibadan	m.01zsrb	GPE
brasil	m.015fr	GPE
Tumblr	m.05pdgbz	ORG
Magreb	m.01yqpw	LOC
cubana	m.0d04z6	GPE
cubano	m.0d04z6	GPE
Elysee	m.01vfbv	FAC
Murica	m.09c7w0	GPE
Parmer	m.0mqhr	GPE
Sudán	m.06tw8	GPE
BFM TV	m.0cl8q_	ORG
Cho La	m.0n48s4h	LOC
Pekín	m.01914	GPE
Aleppo	m.01505k	GPE
Kunlun	m.02lnhb	LOC
TUI AG	m.04jvfj	ORG
Atenas	m.0n2z	GPE
Toyota	m.07mb6	ORG
ISRAEL	m.03spz	GPE
Ramadi	m.01kk8b	GPE
Bután	m.07bxhl	GPE
Baltic	m.01xrc5	LOC
London	m.04jpl	GPE
Nanyue	m.067284	GPE
Texaco	m.0g499	ORG
Hainan	m.0166br	GPE
Zhuhai	m.01nm71	GPE
Yunnan	m.0166b8	GPE
irakie	m.0d05q4	GPE
Mossad	m.03prx	ORG
Ankara	m.0jyw	GPE
Canada	m.0d060g	GPE
Gander	m.028n38	GPE
Alaska	m.0hjy	GPE
Denver	m.02cl1	GPE
Lubeck	m.04hhb	GPE
Hohhot	m.01mvtw	GPE	NAM
Kuwait	m.047yc	GPE
Europe	m.02j9z	LOC
Europa	m.02j9z	LOC
Shabab	m.027ggxz	ORG
israel	m.03spz	GPE
Brasil	m.015fr	GPE
Yahoo!	m.019rl6	ORG
Adidas	m.01jtml	ORG
UNESCO	m.05yg8kx	ORG
Israel	m.03spz	GPE
Oaxaca	m.014m1m	GPE
Mexico	m.0b90_r	GPE
SCOTUS	m.07sz1	ORG
Jersey	m.05fjf	GPE
Túnez	m.0ftn8	GPE
Manaos	m.02bkk3	GPE
kurdos	m.0kwd9	GPE
Boston	m.01cx_	GPE
Indian	m.03rk0	GPE
afghan	m.0jdd	GPE
Saudis	m.01z215	GPE
Odessa	m.013mj_	GPE
Hawaii	m.03gh4	GPE
Google	m.045c7b	ORG
mexico	m.0b90_r	GPE
Moscú	m.04swd	GPE
Meretz	m.02hbdk	ORG
Benín	m.0164v	GPE
Bombay	m.04vmp	GPE
Oregon	m.05kj_	GPE
Tehran	m.0ftlx	GPE
Panama	m.05qx1	GPE
Disney	m.09b3v	ORG
Gibson	m.01chbr	ORG
Warner	m.074byn	PER
Oakley	m.028tf_	ORG
Istael	m.03spz	GPE
BRASIL	m.015fr	GPE
Suecia	m.0d0vqn	GPE
Kenyan	m.019rg5	GPE
Marino	m.05p0kgt	GPE
Marina	m.01skqzw	ORG
Grozni	m.011l4t	GPE
google	m.045c7b	ORG
Moscow	m.04swd	GPE
Össur	m.043lcc6	ORG
Russia	m.06bnz	GPE
Yemeni	m.01z88t	GPE
Dubái	m.01f08r	GPE
Austin	m.0vzm	GPE
Mencio	m.01b_fn	PER
Manbij	m.012w_b	GPE
Manbiy	m.012w_b	GPE
Tories	m.07wpm	ORG
EE.UU.	m.09c7w0	GPE
Unasur	m.04mj68	ORG
Arabia	m.0cvmv	LOC
French	m.0f8l9c	GPE
Borneo	m.01fzp	GPE
UBS AG	m.031rxp	ORG
iraní	m.03shp	GPE
Haití	m.03gyl	GPE
Nevada	m.059_c	GPE
tui ag	m.04jvfj	ORG
Kaduna	m.05349k	GPE
Madrid	m.056_y	GPE
Xinhua	m.01n13b	ORG
Greece	m.035qy	GPE
Suzhou	m.01qq80	GPE	NAM
Iguala	m.06xs0p	GPE
Tíbet	m.0f8nf	GPE
Ramala	m.0c11l	GPE
Hebron	m.09lvk	GPE
Aurora	m.0s69k	GPE
Xiamen	m.0126c3	GPE
Repubs	m.07wbk	ORG
Somali	m.06tgw	GPE
Cyprus	m.01ppq	GPE
arabia	m.0cvmv	LOC
Barawe	m.09rq90	GPE
Oxford	m.05l5n	GPE
Nansha	m.03ql9tq	GPE	NAM
Sderot	m.02czws	GPE
Chibok	m.0806x24	GPE
Shanxi	m.0kzcv	GPE
Nordic	m.01531v	LOC
turcas	m.01znc_	GPE
usanos	m.09c7w0	GPE
tumblr	m.05pdgbz	ORG
Senado	m.0frwk1	ORG
Armada	m.07wg3	ORG
Yibuti	m.027jk	GPE
Japón	m.03_3d	GPE
Tuzla	m.02lg4b	GPE
Hatra	m.01cgqw	GPE
Spain	m.06mkj	GPE
Hunan	m.01669t	GPE
Cairo	m.01w2v	GPE
India	m.03rk0	GPE
Borno	m.06xjkq	GPE
Nixon	m.06c97	PER
Haiti	m.03gyl	GPE
DARPA	m.02gv2	ORG
Burma	m.04xn_	GPE
Korea	m.06qd3	GPE
Paige	NIL10004	PER
Libia	m.04gqr	GPE
Gombe	m.08jlk8	GPE
Enron	m.02rsc	ORG
Gales	m.0j5g9	GPE
Rusos	m.06bnz	GPE
Yahoo	m.019rl6	ORG
Tampa	m.0n1rj	GPE
Ellis	m.0mrwx	GPE
Kenia	m.019rg5	GPE
Hamas	m.03m6j	ORG
Xi'an	m.0kzd9	GPE
Benue	m.05b32s	GPE
Qatar	m.0697s	GPE
Mosad	m.03prx	ORG
Abuya	m.0fnxw	GPE
Vilna	m.07_kq	GPE
Lhasa	m.01jmlw	GPE
Berna	m.0d6nx	GPE
Siria	m.06vbd	GPE
EE UU	m.09c7w0	GPE
rusos	m.06bnz	GPE
Njaba	m.09g6q21	GPE
Ossur	m.043lcc6	ORG
libia	m.04gqr	GPE
rusas	m.06bnz	GPE
Mecca	m.058wp	GPE
Hefei	m.012c8s	GPE	NAM
Odesa	m.0ffmp	GPE
Naija	m.05cgv	GPE
Tokio	m.07dfk	GPE
Nepal	m.016zwt	GPE
Amán	m.0c7zf	GPE
Dutch	m.059j2	GPE
Viena	m.0fhp9	GPE
Islam	m.0flw86	ORG
Sirio	m.06vbd	GPE
Anwar	m.02czqj	GPE
Sochi	m.0m465	GPE
u. s.	m.09c7w0	GPE
U.S.A	m.09c7w0	GPE
Irán	m.03shp	GPE
CHINA	m.0d05w3	GPE
Idaho	m.03s5t	GPE
Quuds	m.0430_	GPE
Texan	m.07b_l	GPE
Irish	m.03rt9	GPE
Czech	m.01mjq	GPE
sirio	m.06vbd	GPE
siria	m.06vbd	GPE
Hebei	m.0jk_8	GPE
Texas	m.07b_l	GPE
Dukku	m.09gczgc	GPE
Sudan	m.06tw8	GPE
iraki	m.0d05q4	GPE
Lagos	m.0lnfy	GPE
TEXAS	m.07b_l	GPE
Bravo	m.01zcrv	ORG
turco	m.01znc_	GPE
Bulls	m.0jm74	ORG
Checa	m.01z91	ORG
Enugu	m.02ttyh	GPE
NISIS	m.027x630	ORG
usana	m.09c7w0	GPE
Derna	m.0dpq0n	GPE
Tunis	m.0ftn8	GPE
RUSIA	m.06bnz	GPE
Minsk	m.0dlxj	GPE
Mafia	m.05489	ORG
Macao	m.04thp	GPE
lagos	m.02y31x	GPE
Alepo	m.01505k	GPE
syria	m.06vbd	GPE
Swiss	m.06mzp	GPE
Perot	m.0bxhx	PER
Nikon	m.03pmfw	ORG
Rusia	m.06bnz	GPE
egypt	m.02k54	GPE
Tonga	m.07fb6	GPE
PEMEX	m.01q3_j	ORG
Huadu	m.03ql9yh	GPE
Delta	m.031qpx	GPE
Malik	m.0h3cltm	PER
Lenin	m.05wh0sh	PER
Agege	m.02rj1_2	GPE
Fatah	m.02zvw	ORG
Baidu	m.05mk8_	ORG
Seúl	m.0hsqf	GPE	NAM
Reich	m.059z0	GPE
Idlib	m.07l57d	GPE
Wigan	m.0gyvgw	GPE
Libya	m.04gqr	GPE
FadeA	m.05k9r6	ORG
RAQQA	m.03hz03	GPE
vasca	m.032n5l	GPE
Ipsos	m.08v0x0	ORG
Gowza	m.080lzr2	GPE
Likud	m.01dcs1	ORG
Congo	m.088xp	GPE
Henan	m.01669b	GPE
doral	m.0rnbt	LOC
Golfo	m.0661z	LOC
Yemen	m.01z88t	GPE
EE.UU	m.09c7w0	GPE
Jinan	m.01l3h7	GPE	NAM
Davis	NIL10001	PER
Pasco	m.0jryt	GPE
Nazis	m.05g9h	ORG
Catar	m.0697s	GPE
Asian	m.0j0k	LOC
EYDAP	m.012w3pq1	ORG
IMTFE	m.02032g	ORG
BFMTV	m.0cl8q_	ORG
MSLSD	m.0152x_	ORG
USCIS	m.021psw	ORG
Irans	m.03shp	GPE
SEALS	m.09j2x	ORG
RUSSO	m.04pnx	LOC
Raqqa	m.03hz03	GPE
agege	m.02rj1_2	GPE
Lybia	m.04gqr	GPE
Dubai	m.01f08r	GPE
Miami	m.0f2v0	GPE
USAID	m.011hwh	ORG
China	m.0d05w3	GPE
Jilin	m.017fy2	GPE
cuban	m.0d04z6	GPE
MSNBC	m.0152x_	ORG
Giron	m.0j7nh2h	LOC
Gwoza	m.080lzr2	GPE
Wajir	m.02696qj	GPE
Volga	m.0h2hw	LOC
SWIFT	m.0cx1t	ORG
Paris	m.05qtj	GPE
Abuja	m.0fnxw	GPE
Daesh	m.07v2k4	ORG
Amman	m.0c7zf	GPE
Umbro	m.05j1g6	ORG
Daura	m.0277lyd	GPE
Ramad	m.01kk8b	GPE
kenya	m.019rg5	GPE
AIPAC	m.018_n5	ORG
Mosul	m.01cgxp	GPE
Fordo	m.0gtv3kk	GPE
Anhui	m.0qb62	GPE	NAM
Lapua	m.03b_3s	LOC
Japan	m.03_3d	GPE
Iraqi	m.0d05q4	GPE
Ekiti	m.05s84z	GPE
Chile	m.01p1v	GPE
Omán	m.05l8y	GPE
EU.UU	m.09c7w0	GPE
Suiza	m.06mzp	GPE
Saudi	m.01z215	GPE
ACLU	m.0vkm	ORG
Mozi	m.01by94	PER
Ohio	m.05kkh	GPE
BsAs	m.01ly5m	GPE
OPAP	m.04gh4st	ORG
FARC	m.06hvg	ORG
G5+1	m.0jwv6z7	ORG
Dell	m.0py9b	ORG
Oman	m.05l8y	GPE
Anon	m.03nr1np	ORG
APGA	m.05_2sq	ORG
USSR	m.05vz3zq	GPE
Roof	NIL10002	PER
Iran	m.03shp	GPE
Farc	m.06hvg	ORG
Chad	m.01p1b	GPE
SWAT	m.012qcd	ORG
IAEA	m.03w28	ORG
Kiev	m.02sn34	GPE
Riad	m.0dlm_	GPE
eBay	m.0z90c	ORG
WNBA	m.0fv18	ORG
Navy	m.07wg3	ORG
Yuba	m.057686	GPE
Zayn	m.0h3cltm	PER
govt	m.0f8l9c	GPE
Cuba	m.0d04z6	GPE
Gray	NIL10000	PER
OEIA	m.03w28	ORG
ISIL	m.027x630	ORG
UEFA	m.07y9k	ORG
Benn	NIL10003	PER
Ford	m.02zs4	ORG
Bern	m.0d6nx	GPE
UNSC	m.07vnr	ORG
Visa	m.01kqjn	ORG
Yale	m.08815	ORG
ESPN	m.0kc6x	ORG
UNAM	m.012gyf	ORG
Roma	m.06c62	GPE
OTAN	m.059dn	ORG
ISIS	m.027x630	ORG
Isis	m.027x630	ORG
Asia	m.0j0k	LOC
OPEC	m.0165_d	ORG
Aqsa	m.011pdv3r	PER
reps	m.07wbk	ORG
Iowa	m.03s0w	GPE
INEC	m.02q2wn5	ORG
Kano	m.02jttf	GPE
Gaza	m.0fdkl	GPE
Nazi	m.05g9h	ORG
Oslo	m.05l64	GPE
IRAK	m.0d05q4	GPE
GCHQ	m.03cn2	ORG
IAAF	m.0lvzl	ORG
RAND	m.01fgv0	ORG
Baga	m.0tkjqnj	GPE
rusa	m.06bnz	GPE
Irna	m.03g2w_	ORG
OSDH	m.0hr9tzh	ORG
Susa	m.03yv6r	GPE
iran	m.03shp	GPE
irak	m.0d05q4	GPE
E.U.	m.09c7w0	GPE
P5+1	m.0jwv6z7	ORG
Nike	m.0lwkh	ORG
Yobe	m.06pqtg	GPE
AMIA	m.08lv20	ORG
DKNY	m.0280wr	ORG
Rusa	m.06bnz	GPE
Penn	m.05tbn	GPE
Arak	m.048zmp	GPE
FIBA	m.045v50	ORG
IRAN	m.03shp	GPE
eeuu	m.09c7w0	GPE
Sony	m.06q07	ORG
LIMA	m.0lpfh	GPE
ICPO	m.03zzx	ORG
Laos	m.04hhv	GPE
Shas	m.01qpl0	ORG
Boko	m.06zrg5s	ORG
ARPA	m.01lk6z	ORG
SEAL	m.09j2x	ORG
NYRB	m.01rdhr	ORG
CCTV	m.0kcyk	ORG
AIAI	m.0dmp1n	ORG
PUMA	m.04cqmpj	ORG
Yola	m.02jtty	GPE
EEUU	m.09c7w0	GPE
Gore	m.0d05fv	PER
Meek	NIL10007	PER
PNAC	m.01c4wz	ORG
SAPS	m.04k77f	ORG
Lamu	m.05b111	GPE
Iraq	m.0d05q4	GPE
Abia	m.03nnh2	GPE
peta	m.0gj8r	ORG
SABC	m.01_sgp	ORG
ruso	m.06bnz	GPE
FIFA	m.02zm3	ORG
Arab	m.0cvmv	LOC
dems	m.0d075m	ORG
Etsy	m.0byvh_	ORG
Suez	m.01k6hh	GPE
Rome	m.06c62	GPE
Utah	m.0jmhr	ORG
USGS	m.01b69s	ORG
nato	m.059dn	ORG
Guam	m.034tl	GPE
Irak	m.0d05q4	GPE
ISOC	m.01cwsb	ORG
CUBA	m.0d04z6	GPE
NYR	m.01rdhr	ORG
NYC	m.02_286	GPE
KKK	m.048qr	ORG
U.E	m.0_6t_z8	ORG
ONU	m.07t65	ORG
CFR	m.01d_8r	ORG
imo	m.02kjj2	GPE
JNS	m.0vpvywc	ORG
APC	m.0r4k3hv	ORG
gop	m.07wbk	ORG
isl	m.027x630	ORG
ECB	m.02l6_	ORG
BBC	m.0ncl8zk	ORG
GUM	m.02vswf	FAC
EBC	m.0gzlc2	ORG
IOC	m.03xcc	ORG
Fed	m.02xmb	ORG
DHS	m.0fytk	ORG
NBC	m.016bvz	ORG
NBA	m.05jvx	ORG
IHS	m.04jb8dq	ORG
YPG	m.0kbh1z3	ORG
VOA	m.0q0r9	ORG
ATF	m.01ymr_	ORG
IMF	m.03y48	ORG
UUP	m.0j8cs	ORG
GOP	m.07wbk	ORG
WTC	m.083_h	FAC
SYD	m.06y57	GPE
MIT	m.05k7sb	GPE
FSB	m.0225tg	ORG
NSA	m.05htt	ORG
Biu	m.080kjp3	GPE
PEN	m.03v1l6	ORG
E.U	m.09c7w0	GPE
FBI	m.02_1m	ORG
USA	m.09c7x0	GPE
cbs	m.09d5h	ORG
ICU	m.0dlrbn	ORG
NPA	m.06mj8k	ORG
NPR	m.0c0sl	ORG
TSR	m.09glgr	ORG
abc	m.0gsg7	ORG
sur	m.06n3y	LOC
OEA	m.05pzq	ORG
AFP	m.02dlk9	ORG
FCO	m.0g7hr	ORG
IBM	m.03sc8	ORG
CAS	m.03r121	ORG
PGR	m.07pw1t	ORG
DoD	m.07y0n	ORG
Imo	m.02kjj2	GPE
PDP	m.024tv3	ORG
BMW	m.017yh	ORG
IRS	m.03z19	ORG
Fry	NIL10006	PER
HBO	m.03mdt	ORG
TUI	m.04jvfj	ORG
pdp	m.0276bn	ORG
ANV	m.02j_vd	ORG
GWB	m.09b6zr	PER
DOJ	m.0dtj5	ORG
cia	m.0d6qjf	ORG
UBC	m.021s0d	ORG
CCP	m.02189	ORG
GDR	m.03f2w	GPE
KGB	m.04b6p	ORG
CBS	m.09d5h	ORG
NHS	m.01fw9h	ORG
ABC	m.0gsg7	ORG
KTM	m.07kd55	ORG
RAF	m.06dqt	ORG
MUD	m.0czf0s1	ORG
ITV	m.0fxqm	ORG
HRW	m.0ckxt	ORG
CNN	m.0gsgr	ORG
EFE	m.022blt	ORG
PLO	m.062dz	ORG
ETA	m.02pvw	ORG
ICJ	m.03vls	ORG
G-7	m.02p3xvj	ORG
ICC	m.03v8k	ORG
Dem	m.0d075m	ORG
CIA	m.0d6qjf	ORG
AQI	m.0v74	ORG
GM	m.035nm	ORG
G8	m.0g8bc	ORG
MN	m.04ykg	GPE
DU	m.02dwm8	ORG
WA	m.081yw	GPE
IG	m.02r52hq	ORG
NJ	m.05fjf	GPE
EI	m.027x630	ORG
EU	m.0_6t_z8	ORG
SY	m.06vbd	GPE
SI	m.027x630	ORG
G7	m.02p3xvj	ORG
Xi	m.06ff60	PER
BR	m.015fr	GPE
AP	m.0cv_2	ORG
AR	m.0jgd	GPE
AZ	m.0vmt	GPE
NY	m.02_286	GPE
NZ	m.0ctw_b	GPE
PT	m.01gqn1	ORG
PA	m.0604m	ORG
BP	m.0k5b5	ORG
FA	m.0chl9	ORG
UE	m.0_6t_z8	ORG
europeos	m.02j9z	LOC	
luna	m.04wv_	LOC
marte	m.09cws	LOC
hispanoamericano	m.02b75d	LOC
Plaza de la Independencia	m.05bss1	FAC
Gran Vía de Madrid	m.09s07b	FAC
Centro de Lanzamientos de Satélite Xichang	m.0379hj	FAC
suramericana	m.06n3y	LOC
eurozona	m.0195tf	LOC
asia	m.0j0k	LOC
La Bombonera	m.03f06p	FAC
mundo	m.02j71	LOC
aeropuerto internacional ruso de Sheremetyevo	m.01n53t	FAC
Altos del Golán	m.03cdz	LOC
pirineo	m.065ky	LOC
mediterráneo	m.04swx	LOC
Cabo de Buena Esperanza	m.0c1y3	LOC
oriente medio	m.04wsz	LOC
bahía de Guantánamo	m.0btt37	LOC
boi taull	m.076y_zt	FAC
Canal de Panama	m.066rl	FAC
América	m.07c5l	LOC
río San Juan	m.06fqnx	LOC
africano	m.0dg3n1	LOC
océano Atlántico	m.0j3b	LOC0
Bahía de los Arco Iris	m.05sb_r	LOC
Palacio de Miraflores	m.05frbv	FAC
Sol	m.06m_p	LOC
centroamericana	m.01tzh	LOC
Sol	m.0b6hk5f	LOC
el Sáhara	m.01w1vt	LOC
plaza de San Pedro	m.03mj05	FAC
La Hispaniola	m.03kn2	LOC
Universidad de Defensa Nacional	m.08jjsk	FAC
La Orchila	m.08flwt	LOC
Las Américas	m.02v4jt	FAC